"aa" = (/turf/space,/area/space)
"ab" = (/turf/simulated/wall/r_wall/prepainted,/area/map_template/merc_spawn)
"ac" = (/obj/structure/closet/syndicate{closet_appearance = /decl/closet_appearance/tactical},/obj/item/clothing/glasses/night,/obj/item/weapon/crowbar/red,/obj/item/weapon/gun/projectile/pistol/holdout,/obj/item/ammo_magazine/pistol/small,/obj/effect/floor_decal/industrial/hatch/grey,/turf/simulated/floor/tiled/dark/monotile,/area/map_template/merc_spawn)
"ad" = (/turf/simulated/floor/tiled/dark,/area/map_template/merc_spawn)
"ae" = (/obj/effect/paint/dark_gunmetal,/turf/simulated/wall/r_titanium,/area/map_template/merc_spawn)
"af" = (/obj/structure/shuttle/engine/propulsion{dir = 4},/obj/structure/shuttle/engine/heater{dir = 8; icon_state = "heater"; pixel_x = 32},/turf/simulated/floor/airless,/area/map_template/merc_spawn)
"ag" = (/obj/structure/bed/chair/shuttle/red,/turf/simulated/floor/tiled/techfloor,/area/map_template/merc_spawn)
"ah" = (/obj/machinery/computer/shuttle_control,/turf/simulated/floor/tiled/techfloor,/area/map_template/merc_spawn)
"ai" = (/obj/machinery/suit_storage_unit/syndie,/turf/simulated/floor/plating,/area/map_template/merc_spawn)
"aj" = (/turf/simulated/floor/tiled/techfloor,/area/map_template/merc_spawn)
"ak" = (/obj/machinery/door/airlock/external/bolted_open,/turf/simulated/floor/tiled/techfloor/grid,/area/map_template/merc_spawn)
"al" = (/obj/machinery/light/small{dir = 1; icon_state = "bulb_map"},/turf/simulated/floor/tiled/techfloor/grid,/area/map_template/merc_spawn)
"am" = (/obj/effect/floor_decal/spline/fancy/wood{icon_state = "spline_fancy"; dir = 1},/turf/simulated/floor/lino,/area/map_template/merc_spawn)
"an" = (/obj/effect/floor_decal/spline/fancy/wood{icon_state = "spline_fancy"; dir = 5},/turf/simulated/floor/lino,/area/map_template/merc_spawn)
"ao" = (/obj/machinery/suit_cycler/syndicate,/turf/simulated/floor/plating,/area/map_template/merc_spawn)
"ap" = (/obj/structure/bed/chair/shuttle/red{icon_state = "shuttle_chair_preview"; dir = 1},/turf/simulated/floor/tiled/techfloor,/area/map_template/merc_spawn)
"aq" = (/obj/machinery/computer/modular/preset/full/merc{icon_state = "computer"; dir = 1},/turf/simulated/floor/tiled/techfloor,/area/map_template/merc_spawn)
"ar" = (/turf/simulated/mineral,/area/space)
"as" = (/obj/effect/step_trigger/thrower{affect_ghosts = 0; direction = 4; icon_state = "eb"; name = "thrower_right"; tiles = 12},/turf/space,/area/space)
"at" = (/obj/effect/step_trigger/thrower{affect_ghosts = 0; direction = 2; icon_state = "sb"; name = "thrower_down"; tiles = 12},/turf/space,/area/space)
"au" = (/obj/effect/step_trigger/thrower{direction = 1; icon_state = "nb"; name = "thrower_up"; nostop = 0; tiles = 12},/turf/space,/area/space)
"av" = (/obj/structure/lattice,/turf/space,/area/space)
"aw" = (/obj/structure/grille,/obj/structure/lattice,/turf/space,/area/space)
"ax" = (/obj/effect/wallframe_spawn/reinforced/no_grille,/turf/simulated/floor/plating,/area/map_template/merc_spawn)
"ay" = (/turf/simulated/floor/lino,/area/map_template/merc_spawn)
"az" = (/obj/effect/floor_decal/spline/fancy/wood{dir = 4},/turf/simulated/floor/lino,/area/map_template/merc_spawn)
"aA" = (/obj/machinery/suit_storage_unit/standard_unit,/obj/machinery/light{dir = 1; icon_state = "tube_map"},/turf/simulated/floor/plating,/area/map_template/merc_spawn)
"aB" = (/obj/structure/dispenser/oxygen,/turf/simulated/floor/plating,/area/map_template/merc_spawn)
"aC" = (/obj/machinery/door/airlock/glass/antagonist,/turf/simulated/floor/tiled/dark,/area/map_template/merc_spawn)
"aD" = (/obj/machinery/door/airlock/antagonist,/turf/simulated/floor/tiled/dark,/area/map_template/merc_spawn)
"aE" = (/obj/machinery/door/blast/shutters{dir = 4; id_tag = "mercequip"; name = "Equipment Storage Shutters"},/turf/simulated/floor/tiled/dark,/area/map_template/merc_spawn)
"aF" = (/turf/simulated/floor/cult,/area/map_template/merc_spawn)
"aG" = (/obj/machinery/door/airlock/multi_tile/antagonist{icon_state = "closed"; dir = 8},/turf/simulated/floor/cult,/area/map_template/merc_spawn)
"aH" = (/obj/machinery/door/airlock/multi_tile/antagonist,/turf/simulated/floor/tiled/dark,/area/map_template/merc_spawn)
"aI" = (/obj/machinery/door/airlock/external{frequency = 1331; id_tag = "merc_base_outer"; name = "Desperado External Airlock"},/turf/simulated/floor/tiled/techfloor/grid,/area/map_template/merc_spawn)
"aJ" = (/obj/machinery/door/airlock/external{frequency = 1331; id_tag = "merc_base_hatch"; name = "Desperado Docking Airlock"},/turf/simulated/floor/tiled/techfloor/grid,/area/map_template/merc_spawn)
"aK" = (/obj/structure/table/steel_reinforced,/turf/simulated/floor/cult,/area/map_template/merc_spawn)
"aL" = (/obj/machinery/embedded_controller/radio/simple_docking_controller{dir = 4; frequency = 1331; id_tag = "merc_base"; pixel_x = -25; req_access = list("ACCESS_CENT_GENERAL"); tag_door = "merc_base_hatch"},/obj/effect/floor_decal/corner/red/half{dir = 8},/turf/simulated/floor/tiled/dark,/area/map_template/merc_spawn)
"aM" = (/obj/structure/bed/chair/comfy/red{icon_state = "comfychair_preview"; dir = 4},/turf/simulated/floor/cult,/area/map_template/merc_spawn)
"aN" = (/turf/simulated/wall/prepainted,/area/map_template/merc_spawn)
"aO" = (/obj/structure/table/glass,/turf/simulated/floor/cult,/area/map_template/merc_spawn)
"aP" = (/obj/structure/bed/chair/comfy/red{icon_state = "comfychair_preview"; dir = 8},/turf/simulated/floor/cult,/area/map_template/merc_spawn)
"aQ" = (/obj/machinery/door/airlock/antagonist,/turf/simulated/floor/tiled/white,/area/map_template/merc_spawn)
"aR" = (/obj/machinery/door/airlock/antagonist,/obj/effect/floor_decal/techfloor/corner{icon_state = "techfloor_corners"; dir = 8},/turf/simulated/floor/tiled/techfloor,/area/map_template/merc_spawn)
"aS" = (/turf/simulated/floor/tiled/white,/area/map_template/merc_spawn)
"aT" = (/obj/effect/floor_decal/corner/red/half{dir = 8},/turf/simulated/floor/tiled/dark,/area/map_template/merc_spawn)
"aU" = (/obj/effect/floor_decal/corner/red/half{dir = 1},/obj/structure/flora/pottedplant/minitree,/turf/simulated/floor/tiled/dark,/area/map_template/merc_spawn)
"aV" = (/obj/effect/floor_decal/corner/red/half{dir = 1},/obj/machinery/light/spot{dir = 1},/turf/simulated/floor/tiled/dark,/area/map_template/merc_spawn)
"aW" = (/obj/effect/floor_decal/corner/red/half{dir = 4},/obj/machinery/light/spot{dir = 4},/obj/structure/table/steel_reinforced,/turf/simulated/floor/tiled/dark,/area/map_template/merc_spawn)
"aX" = (/obj/effect/floor_decal/corner/red/half{dir = 4},/obj/structure/table/steel_reinforced,/turf/simulated/floor/tiled/dark,/area/map_template/merc_spawn)
"aY" = (/obj/effect/floor_decal/corner/red/half{dir = 4},/obj/structure/flora/pottedplant/stoutbush,/turf/simulated/floor/tiled/dark,/area/map_template/merc_spawn)
"aZ" = (/obj/structure/table/rack,/obj/structure/railing/mapped{dir = 4; icon_state = "railing0-1"},/obj/item/weapon/storage/box/teargas,/obj/item/weapon/storage/box/smokes,/obj/item/weapon/storage/box/flashbangs,/obj/item/weapon/storage/box/handcuffs,/obj/effect/floor_decal/industrial/outline/grey,/turf/simulated/floor/tiled/dark/monotile,/area/map_template/merc_spawn)
"ba" = (/obj/structure/table/rack,/obj/structure/railing/mapped{dir = 8; icon_state = "railing0-1"},/obj/item/weapon/gun/energy/gun,/obj/item/weapon/gun/energy/gun,/obj/item/weapon/gun/energy/ionrifle/small,/obj/effect/floor_decal/industrial/outline/grey,/turf/simulated/floor/tiled/dark/monotile,/area/map_template/merc_spawn)
"bb" = (/obj/machinery/power/apc{dir = 1; name = "north bump"; pixel_y = 24},/obj/structure/cable{icon_state = "0-2"; d2 = 2},/turf/simulated/floor/tiled/techfloor/grid,/area/map_template/merc_spawn)
"bc" = (/obj/effect/floor_decal/techfloor{icon_state = "techfloor_edges"; dir = 10},/obj/effect/floor_decal/techfloor/hole/right,/turf/simulated/floor/tiled/techfloor,/area/map_template/merc_spawn)
"bd" = (/obj/effect/floor_decal/techfloor,/turf/simulated/floor/tiled/techfloor,/area/map_template/merc_spawn)
"be" = (/obj/structure/cable{d1 = 1; d2 = 4; icon_state = "1-4"},/obj/machinery/computer/modular/preset/full/merc{icon_state = "computer"; dir = 1},/turf/simulated/floor/tiled/techfloor/grid,/area/map_template/merc_spawn)
"bf" = (/obj/structure/cable{d2 = 8; icon_state = "0-8"},/obj/machinery/power/smes/buildable/max_cap_in_out,/obj/machinery/light/small,/turf/simulated/floor/tiled/techfloor/grid,/area/map_template/merc_spawn)
"bg" = (/obj/structure/table/rack,/obj/machinery/light/spot{dir = 1},/obj/item/weapon/gun/projectile/pistol/military,/obj/item/weapon/gun/projectile/pistol/military,/obj/item/ammo_magazine/pistol/double,/obj/item/ammo_magazine/pistol/double,/obj/effect/floor_decal/industrial/outline/grey,/turf/simulated/floor/tiled/dark/monotile,/area/map_template/merc_spawn)
"bh" = (/obj/structure/table/rack,/obj/structure/railing/mapped{dir = 4; icon_state = "railing0-1"},/obj/item/weapon/gun/projectile/revolver,/obj/item/ammo_magazine/speedloader/magnum,/obj/item/ammo_magazine/speedloader/magnum,/obj/effect/floor_decal/industrial/outline/grey,/turf/simulated/floor/tiled/dark/monotile,/area/map_template/merc_spawn)
"bi" = (/obj/structure/table/rack,/obj/structure/railing/mapped{dir = 8; icon_state = "railing0-1"},/obj/item/weapon/storage/backpack/dufflebag/syndie/ammo,/obj/item/weapon/storage/backpack/dufflebag/syndie/med,/obj/effect/floor_decal/industrial/outline/grey,/turf/simulated/floor/tiled/dark/monotile,/area/map_template/merc_spawn)
"bj" = (/obj/machinery/suit_storage_unit/standard_unit,/turf/simulated/floor/plating,/area/map_template/merc_spawn)
"bk" = (/obj/machinery/telecomms/allinone{intercept = 1},/turf/simulated/floor/tiled/techfloor/grid,/area/map_template/merc_spawn)
"bl" = (/obj/machinery/computer/modular/preset/full/merc,/turf/simulated/floor/cult,/area/map_template/merc_spawn)
"bm" = (/obj/effect/floor_decal/corner/red/half{dir = 4},/obj/structure/noticeboard{dir = 8; pixel_x = 32},/obj/structure/table/steel_reinforced,/turf/simulated/floor/tiled/dark,/area/map_template/merc_spawn)
"bn" = (/obj/effect/floor_decal/corner/red/half{dir = 8},/obj/machinery/light{dir = 1; icon_state = "tube_map"},/obj/machinery/button/blast_door{desc = "A remote blast door control."; dir = 4; id_tag = "mercship"; name = "Desperado Access Button"; pixel_x = -23; pixel_y = 0},/turf/simulated/floor/tiled/dark,/area/map_template/merc_spawn)
"bo" = (/obj/structure/table/rack,/obj/machinery/light_switch{dir = 4; pixel_x = -24},/obj/item/weapon/storage/belt/utility/full_buy{icon_state = "gearbelt"},/obj/effect/floor_decal/industrial/outline/grey,/obj/item/weapon/storage/belt/utility/full_buy{icon_state = "gearbelt"},/turf/simulated/floor/tiled/dark/monotile,/area/map_template/merc_spawn)
"bp" = (/obj/machinery/light/spot{icon_state = "tube_map"; dir = 4},/obj/structure/closet/syndicate{closet_appearance = /decl/closet_appearance/tactical},/obj/item/clothing/glasses/night,/obj/item/weapon/crowbar/red,/obj/item/weapon/gun/projectile/pistol/holdout,/obj/item/ammo_magazine/pistol/small,/obj/effect/floor_decal/industrial/hatch/grey,/turf/simulated/floor/tiled/dark/monotile,/area/map_template/merc_spawn)
"bq" = (/obj/structure/table/rack,/obj/item/weapon/inflatable_dispenser,/obj/item/weapon/inflatable_dispenser,/turf/simulated/floor/lino,/area/map_template/merc_spawn)
"br" = (/obj/structure/table/rack,/obj/machinery/light/spot{dir = 1},/obj/item/clothing/glasses/welding/superior,/obj/item/clothing/glasses/welding/superior,/obj/item/clothing/gloves/insulated/combat,/obj/effect/floor_decal/industrial/outline/grey,/obj/item/clothing/gloves/insulated/combat,/turf/simulated/floor/tiled/dark/monotile,/area/map_template/merc_spawn)
"bs" = (/obj/structure/table/rack,/obj/item/weapon/pinpointer/nukeop,/obj/item/weapon/pinpointer/nukeop,/obj/item/weapon/pinpointer/nukeop,/obj/item/weapon/pinpointer/nukeop,/obj/effect/floor_decal/industrial/outline/grey,/turf/simulated/floor/tiled/dark/monotile,/area/map_template/merc_spawn)
"bt" = (/obj/structure/table/rack,/obj/structure/railing/mapped{dir = 4; icon_state = "railing0-1"},/obj/machinery/light/spot{dir = 1},/obj/item/device/flash,/obj/item/device/flash,/obj/item/device/flash,/obj/item/device/flash,/obj/effect/floor_decal/industrial/outline/grey,/turf/simulated/floor/tiled/dark/monotile,/area/map_template/merc_spawn)
"bu" = (/obj/structure/table/rack,/obj/item/stack/material/aluminium/fifty,/obj/item/stack/material/plastic/fifty,/obj/item/stack/material/steel/fifty,/obj/item/stack/material/glass/fifty,/obj/effect/floor_decal/industrial/outline/grey,/turf/simulated/floor/tiled/dark/monotile,/area/map_template/merc_spawn)
"bv" = (/obj/machinery/fabricator{desc = "Your typical Autolathe. It appears to have much more options than your regular one, however..."; fab_status_flags = 1; name = "unlocked autolathe"},/obj/machinery/light/spot{icon_state = "tube_map"; dir = 4},/obj/effect/floor_decal/industrial/outline/grey,/turf/simulated/floor/tiled/dark/monotile,/area/map_template/merc_spawn)
"bw" = (/obj/machinery/vending/clothing/tact,/obj/effect/floor_decal/industrial/outline/grey,/turf/simulated/floor/tiled/dark/monotile,/area/map_template/merc_spawn)
"bx" = (/obj/structure/closet/secure_closet/freezer/fridge{req_access = list("ACCESS_SYNDICATE")},/turf/simulated/floor/tiled/white,/area/map_template/merc_spawn)
"by" = (/obj/structure/table/rack,/obj/machinery/light/spot,/obj/item/weapon/storage/belt/medical,/obj/item/weapon/storage/belt/medical,/obj/effect/floor_decal/industrial/outline/grey,/turf/simulated/floor/tiled/dark/monotile,/area/map_template/merc_spawn)
"bz" = (/obj/structure/table/rack,/obj/item/weapon/storage/belt/holster/security/tactical,/obj/item/weapon/storage/belt/holster/security/tactical,/obj/effect/floor_decal/industrial/outline/grey,/turf/simulated/floor/tiled/dark/monotile,/area/map_template/merc_spawn)
"bA" = (/obj/structure/table/rack,/obj/item/weapon/storage/belt/holster/security,/obj/effect/floor_decal/industrial/outline/grey,/turf/simulated/floor/tiled/dark/monotile,/area/map_template/merc_spawn)
"bB" = (/obj/structure/table/rack,/obj/item/clothing/accessory/storage/holster/thigh,/obj/item/clothing/accessory/storage/holster/thigh,/obj/item/clothing/accessory/storage/holster/thigh,/obj/item/clothing/accessory/storage/holster/thigh,/obj/effect/floor_decal/industrial/outline/grey,/turf/simulated/floor/tiled/dark/monotile,/area/map_template/merc_spawn)
"bC" = (/obj/structure/table/rack,/obj/machinery/light/spot,/obj/item/clothing/accessory/storage/white_vest,/obj/item/clothing/accessory/storage/white_vest,/obj/item/clothing/accessory/storage/black_vest,/obj/item/clothing/accessory/storage/black_vest,/obj/item/clothing/accessory/storage/brown_vest,/obj/effect/floor_decal/industrial/outline/grey,/turf/simulated/floor/tiled/dark/monotile,/area/map_template/merc_spawn)
"bD" = (/obj/structure/table/rack,/obj/structure/railing/mapped{dir = 4; icon_state = "railing0-1"},/obj/item/clothing/accessory/storage/bandolier,/obj/item/clothing/accessory/storage/bandolier,/obj/effect/floor_decal/industrial/outline/grey,/turf/simulated/floor/tiled/dark/monotile,/area/map_template/merc_spawn)
"bE" = (/obj/structure/table/rack,/obj/structure/railing/mapped{dir = 8; icon_state = "railing0-1"},/obj/item/weapon/tank/jetpack/oxygen,/obj/item/weapon/tank/jetpack/oxygen,/obj/item/weapon/tank/jetpack/oxygen,/obj/item/weapon/tank/jetpack/carbondioxide,/obj/item/weapon/tank/jetpack/carbondioxide,/obj/effect/floor_decal/industrial/outline/grey,/turf/simulated/floor/tiled/dark/monotile,/area/map_template/merc_spawn)
"bF" = (/obj/machinery/light/spot,/obj/machinery/portable_atmospherics/canister/oxygen,/obj/effect/floor_decal/industrial/outline/yellow,/turf/simulated/floor/tiled/dark/monotile,/area/map_template/merc_spawn)
"bG" = (/obj/machinery/door/airlock/external{frequency = 1331; id_tag = "merc_base_hatch"; name = "Desperado Docking Airlock"},/obj/machinery/door/blast/shutters{dir = 4; id_tag = "mercship"; name = "Desperado Access Shutters"},/turf/simulated/floor/tiled/techfloor/grid,/area/map_template/merc_spawn)
"bH" = (/obj/machinery/door/airlock/multi_tile/antagonist{icon_state = "closed"; dir = 8},/obj/machinery/door/blast/shutters{dir = 4; id_tag = "mercequip"; name = "Equipment Storage Shutters"},/turf/simulated/floor/tiled/dark,/area/map_template/merc_spawn)
"bI" = (/obj/machinery/door/window,/obj/structure/window/reinforced{icon_state = "rwindow"; dir = 8},/turf/simulated/floor/cult,/area/map_template/merc_spawn)
"bJ" = (/obj/structure/flora/pottedplant/stoutbush,/turf/simulated/floor/cult,/area/map_template/merc_spawn)
"bK" = (/obj/machinery/suit_storage_unit/syndie,/obj/machinery/light/spot{icon_state = "tube_map"; dir = 4},/turf/simulated/floor/plating,/area/map_template/merc_spawn)
"bL" = (/obj/structure/table/steel_reinforced,/obj/structure/sign/double/map/right{pixel_y = 32},/obj/item/weapon/paper_bin,/obj/item/weapon/pen,/turf/simulated/floor/cult,/area/map_template/merc_spawn)
"bM" = (/obj/structure/table/steel_reinforced,/obj/machinery/chemical_dispenser/bar_alc/full,/turf/simulated/floor/cult,/area/map_template/merc_spawn)
"bN" = (/obj/effect/floor_decal/corner/red/half{dir = 4},/obj/structure/flora/pottedplant/large,/obj/machinery/light{dir = 1; icon_state = "tube_map"},/turf/simulated/floor/tiled/dark,/area/map_template/merc_spawn)
"bO" = (/obj/machinery/light/spot{dir = 8},/turf/simulated/floor/cult,/area/map_template/merc_spawn)
"bP" = (/obj/machinery/light/spot{icon_state = "tube_map"; dir = 4},/turf/simulated/floor/cult,/area/map_template/merc_spawn)
"bQ" = (/obj/machinery/light{icon_state = "tube_map"; dir = 8},/turf/simulated/floor/tiled/white,/area/map_template/merc_spawn)
"bR" = (/obj/machinery/light{dir = 4},/turf/simulated/floor/tiled/white,/area/map_template/merc_spawn)
"bS" = (/obj/structure/bed/chair/shuttle/red{icon_state = "shuttle_chair_preview"; dir = 1},/obj/machinery/light/small,/turf/simulated/floor/tiled/techfloor,/area/map_template/merc_spawn)
"bT" = (/obj/structure/bed/chair/shuttle/red,/obj/machinery/light/small{dir = 1; icon_state = "bulb_map"},/turf/simulated/floor/tiled/techfloor,/area/map_template/merc_spawn)
"bU" = (/obj/machinery/portable_atmospherics/canister/oxygen,/obj/machinery/light{dir = 4},/turf/simulated/floor/plating,/area/map_template/merc_spawn)
"bV" = (/obj/structure/table/steel_reinforced,/obj/machinery/chemical_dispenser/bar_soft/full,/turf/simulated/floor/cult,/area/map_template/merc_spawn)
"bW" = (/obj/structure/table/steel_reinforced,/obj/machinery/chemical_dispenser/bar_coffee/full,/turf/simulated/floor/cult,/area/map_template/merc_spawn)
"bX" = (/obj/machinery/acting/changer,/turf/simulated/floor/lino,/area/map_template/merc_spawn)
"bY" = (/obj/structure/table/steel_reinforced,/obj/item/modular_computer/pda/syndicate,/obj/item/modular_computer/pda/syndicate,/turf/simulated/floor/cult,/area/map_template/merc_spawn)
"bZ" = (/obj/structure/table/steel_reinforced,/obj/structure/sign/double/map/left{pixel_y = 32},/obj/item/weapon/storage/box/mixedglasses,/turf/simulated/floor/cult,/area/map_template/merc_spawn)
"ca" = (/obj/structure/table/steel_reinforced,/obj/machinery/button/blast_door{dir = 4; id_tag = "mercequip"; name = "Equipment Storage Shutters Control"; pixel_x = 5; pixel_y = 7},/turf/simulated/floor/cult,/area/map_template/merc_spawn)
"cb" = (/obj/structure/closet/secure_closet/freezer/kitchen{req_access = null},/turf/simulated/floor/tiled/white,/area/map_template/merc_spawn)
"cc" = (/obj/structure/hygiene/sink/kitchen{pixel_y = 24},/turf/simulated/floor/tiled/white,/area/map_template/merc_spawn)

(1,1,1) = {"
asatatatatatatatatatatatatatatatatatatararararararararararararararararararararararararararararararar
asaaaaaaaaaaaaaaaaaaaaaaaaaaaaaaaaaaaaaaaaaaarararararararararararararararararararararararararararar
asaaaaaaaaaaaaaaaaaaaaaaaaaaaaaaaaaaaaaaaaaaaaaaaaaaaaaaarararararararararararararararararararararar
asaaaaaaaaaaaaaaaaaaaaaaaaaaaaaaaaaaaaaaaaaaaaaaaaaaaaaaaaaaarararararararararararararararararararar
asaaaaaaaaaaaaaaaaaaaaaaaaaaaaaaaaaaaaaaaaaaaaaaaaaaaaaaaaaaaaararararararararararararararararararar
asaaaaaaaaaaaaaaaaaaaaaaaaaaaaaaaaaaaaaeaeaeaeaeaeaeaeaaaaabababababararaNaNaNaNaNaNaNaNaNararararar
asaaaaaaaaaaaaaaaaaaaaaaaaaaaaaaaaaaaaafaeagbTagbTahaeabababbjaAbjaNaNaraNaiadaiaNacadacaNararararar
asaaaaaaaaaaaaaaaaaaaaaaaaaaaaaaaaaaaaafaeajajajajajakakalakamamanaoaNaraNaiadbKaNacadbpaNararararar
asaaaaaaaaaaaaaaaaaaaaaaaaaaaaaaaaaaaaafaeapbSapbSaqaeabaxabbXayazbUaNaraNaiadaiaNacadacaNararararar
asaaaaaaaaaaaaaaaaaaaaaaaaaaaaaaaaaaaaaeaeaeaeaeaeaeaeaaavabbqayazaBaNaraNaxaCaxaNaxaCaxaNaNarararar
asaaaaaaaaaaaaaaaaaaaaaaaaaaaaaaaaaaaaaaaaaaaaaaaaaaaaaaavabaNaDaNaNaNaNaNaZadbabgbhadbibraNaNararar
asaaaaaaaaaaaaaaaaaaaaaaaaaaaaaaaaaaaaaaaaaaaaaaaaaaaaawavaxaTadaVaUaNbsbtadadadadadadadadbuaNararar
asaaaaaaaaaaaaaaaaaaaaaaaaaaaaaaaaaaaaaaaaaaaaaaaaaaaaawaaaxaTadadadaEadadadadadadadadadadbvaNararar
asaaaaaaaaaaaaaaaaaaaaaaaaaaaaaaaaaaaaaaaaaaaaaaaaaaaaawavaxaTadadadbHadadadadadadadadadadbwaNararar
asaaaaaaaaaaaaaaaaaaaaaaaaaaaaaaaaaaaaaaaaaaaaaaaaaaaaaaaaaxaTadadaYaNbobybzbAbBbCbDadbEbFaNaNararar
asaaaaaaaaaaaaaaaaaaaaaaaaaaaaaaaaaaaaaaaaaaaaaaaaaaaaawavaxaTadadaWaNaNaNaNaNaNaNaNaCaNaNaNarararar
asaaaaaaaaaaaaaaaaaaaaaaaaaaaaaaaaaaaaaaaaaaaaaaaaaaaaawaaaxaTadadaXaNbMbVbWbZbLbYblaFaNarararararar
asaaaaaaaaaaaaaaaaaaaaaaaaaaaaaaaaaaaaaaaaaaaaaaaaaaaaawavaxaTadadadaFaFaFaFaFaFcaaPbPaNarararararar
asaaaaaaaaaaaaaaaaaaaaaaaaaaaaaaaaaaaaaaaaaaaaaaaaaaaaaaavaxaTadadadaGaFaFaFaFaFaKaFaFaNarararararar
asaaaaaaaaaaaaaaaaaaaaaaaaaaaaaaaaaaaaaaaaaaaaaaaaaaaaaaavabaNaHadaNaNaFaMaOaPaFaKaKbIaNarararararar
asaaaaaaaaaaaaaaaaaaaaaaaaaaaaaaaaaaaaaaaaaaaaaaaaaaaeabababbnadadbNaNaFaMaOaPaFaFaFaFaNarararararar
asaaaaaaaaaaaaaaaaaaaaaaaaaaaaaaaaaaaaaaaaaaaaaaaaaaaIaJalbGadadadbmaNbOaMaOaPaFaFaFbPaNarararararar
asaaaaaaaaaaaaaaaaaaaaaaaaaaaaaaaaaaaaaaaaaaaaaaaaaaaeabababaLadadaXaNbJaFaFaFaFaFaFaFaNarararararar
asaaaaaaaaaaaaaaaaaaaaaaaaaaaaaaaaaaaaaaaaaaaaaaaaaaaaaaaaababaxaxababaNaNaQaNaNaNaNaRaNaNararararar
asaaaaaaaaaaaaaaaaaaaaaaaaaaaaaaaaaaaaaaaaaaaaaaaaaaaaaaaaaaavaaaaavaraNccaScbbxaNbbbcbdaNararararar
asaaaaaaaaaaaaaaaaaaaaaaaaaaaaaaaaaaaaaaaaaaaaaaaaaaaaaaaaaaawawawavarabbQaSaSbRaNbebfbkaNararararar
asaaaaaaaaaaaaaaaaaaaaaaaaaaaaaaaaaaaaaaaaaaaaaaaaaaaaaaaaaaaaaaawavarabaSaSaSaSaNaNaNaNaNararararar
asaaaaaaaaaaaaaaaaaaaaaaaaaaaaaaaaaaaaaaaaaaaaaaaaaaaaaaaaaaaaaaaaaaarabaSaSaSaSaNararararararararar
asaaaaaaaaaaaaaaaaaaaaaaaaaaaaaaaaaaaaaaaaaaaaaaaaaaaaaaaaaaaaaaawavavabaNaNaNaNaNararararararararar
asaaaaaaaaaaaaaaaaaaaaaaaaaaaaaaaaaaaaaaaaaaaaaaaaaaaaaaaaaaaaaaawaaavararararararararararararararar
asaaaaaaaaaaaaaaaaaaaaaaaaaaaaaaaaaaaaaaaaaaaaaaaaaaaaaaaaaaaaaaawavavavarararararararararararararar
asaaaaaaaaaaaaaaaaaaaaaaaaaaaaaaaaaaaaaaaaaaaaaaaaaaaaaaaaaaaaaaawaaaaavarararararararararararararar
asaaaaaaaaaaaaaaaaaaaaaaaaaaaaaaaaaaaaaaaaaaaaaaaaaaaaaaaaaaaaaaawavavavavararararararararararararar
asaaaaaaaaaaaaaaaaaaaaaaaaaaaaaaaaaaaaaaaaaaaaaaaaaaaaaaaaaaaaaaaaavaaavaaaaarararararararararararar
asaaaaaaaaaaaaaaaaaaaaaaaaaaaaaaaaaaaaaaaaaaaaaaaaaaaaaaaaaaaaaaaaawawawavavarararararararararararar
asaaaaaaaaaaaaaaaaaaaaaaaaaaaaaaaaaaaaaaaaaaaaaaaaaaaaaaaaaaaaaaaaaaaaawaaararararararararararararar
asaaaaaaaaaaaaaaaaaaaaaaaaaaaaaaaaaaaaaaaaaaaaaaaaaaaaaaaaaaaaaaaaaaaaawavararararararararararararar
asaaaaaaaaaaaaaaaaaaaaaaaaaaaaaaaaaaaaaaaaaaaaaaaaaaaaaaaaaaaaaaaaaaaaaaaaararararararararararararar
asaaaaaaaaaaaaaaaaaaaaaaaaaaaaaaaaaaaaaaaaaaaaaaaaaaaaaaaaaaaaaaaaaaaaaaarararararararararararararar
asauauauauauauauauauauauauauauauauauauauauauauauauauauauauauauauauauauararararararararararararararar
"}
