"aa" = (/turf/unsimulated/mineral,/area/map_template/ninja_dojo/dojo)
"ab" = (/turf/simulated/mineral,/area/map_template/ninja_dojo/dojo)
"ac" = (/obj/random/snowland,/turf/simulated/floor/snow,/area/map_template/ninja_dojo/dojo)
"ad" = (/turf/simulated/wall/walnut,/area/map_template/ninja_dojo/dojo)
"ae" = (/obj/structure/table/glass,/obj/item/weapon/storage/firstaid/surgery,/obj/item/weapon/reagent_containers/spray/cleaner,/obj/item/weapon/reagent_containers/spray/sterilizine,/turf/simulated/floor/tiled/dark,/area/map_template/ninja_dojo/dojo)
"af" = (/obj/machinery/optable,/turf/simulated/floor/tiled/dark,/area/map_template/ninja_dojo/dojo)
"ag" = (/obj/structure/closet/medical_wall{pixel_y = 32},/obj/item/weapon/tank/anesthetic,/obj/item/clothing/mask/breath/medical,/obj/item/clothing/gloves/latex,/obj/item/clothing/mask/surgical,/obj/structure/hygiene/sink{dir = 1; pixel_y = 16},/obj/item/weapon/reagent_containers/glass/bottle/stoxin,/obj/item/weapon/reagent_containers/glass/bottle/stoxin,/obj/item/weapon/reagent_containers/syringe,/turf/simulated/floor/tiled/dark,/area/map_template/ninja_dojo/dojo)
"ah" = (/obj/structure/table/glass,/obj/item/weapon/reagent_containers/ivbag/blood/OMinus,/obj/item/weapon/reagent_containers/ivbag/blood/OMinus,/obj/structure/window/reinforced/crescent{dir = 4},/turf/simulated/floor/tiled/dark,/area/map_template/ninja_dojo/dojo)
"ai" = (/obj/machinery/atmospherics/unary/cryo_cell,/turf/simulated/floor/tiled/dark,/area/map_template/ninja_dojo/dojo)
"aj" = (/obj/machinery/atmospherics/portables_connector,/obj/machinery/portable_atmospherics/canister/oxygen/prechilled,/turf/simulated/floor/tiled/dark,/area/map_template/ninja_dojo/dojo)
"ak" = (/obj/item/weapon/reagent_containers/glass/beaker/cryoxadone,/obj/structure/table/glass,/turf/simulated/floor/tiled/dark,/area/map_template/ninja_dojo/dojo)
"al" = (/obj/effect/wallframe_spawn/reinforced/wood,/turf/simulated/floor/plating,/area/map_template/ninja_dojo/dojo)
"am" = (/obj/structure/hygiene/sink{dir = 8; icon_state = "sink"; pixel_x = -22; pixel_y = 0},/turf/simulated/floor/tiled/dark,/area/map_template/ninja_dojo/dojo)
"an" = (/turf/simulated/floor/tiled/white,/area/map_template/ninja_dojo/dojo)
"ao" = (/obj/structure/table/glass,/obj/item/weapon/storage/firstaid/o2,/obj/item/weapon/storage/firstaid/fire{pixel_x = 1},/obj/structure/window/reinforced/crescent{dir = 4},/turf/simulated/floor/tiled/dark,/area/map_template/ninja_dojo/dojo)
"ap" = (/obj/machinery/atmospherics/pipe/simple/hidden{dir = 5; icon_state = "intact"},/turf/simulated/floor/tiled/white,/area/map_template/ninja_dojo/dojo)
"aq" = (/obj/machinery/atmospherics/pipe/simple/hidden{dir = 9},/turf/simulated/floor/tiled/white,/area/map_template/ninja_dojo/dojo)
"ar" = (/obj/structure/table/glass,/obj/item/weapon/storage/box/beakers,/turf/simulated/floor/tiled/dark,/area/map_template/ninja_dojo/dojo)
"as" = (/obj/machinery/computer/teleporter,/turf/simulated/floor/plating,/area/map_template/ninja_dojo/dojo)
"at" = (/obj/machinery/teleport/station,/turf/simulated/floor/plating,/area/map_template/ninja_dojo/dojo)
"au" = (/obj/machinery/teleport/hub,/obj/effect/floor_decal/industrial/hatch/yellow,/turf/simulated/floor/plating,/area/map_template/ninja_dojo/dojo)
"av" = (/obj/structure/table/woodentable/walnut,/obj/item/weapon/flame/candle,/turf/simulated/floor/wood/walnut,/area/map_template/ninja_dojo/dojo)
"aw" = (/obj/structure/table/rack{desc = "A simple wooden altar covered in cloth."; icon = 'icons/obj/cult.dmi'; icon_state = "churchaltar"; name = "wooden altar"},/obj/item/weapon/material/sword/katana,/turf/simulated/floor/wood/walnut,/area/map_template/ninja_dojo/dojo)
"ax" = (/turf/simulated/floor/wood/maple,/area/map_template/ninja_dojo/dojo)
"ay" = (/obj/structure/table/glass,/obj/item/weapon/reagent_containers/syringe/antiviral,/obj/item/weapon/reagent_containers/syringe/antiviral,/obj/item/stack/medical/advanced/bruise_pack,/turf/simulated/floor/tiled/dark,/area/map_template/ninja_dojo/dojo)
"az" = (/obj/structure/table/glass,/obj/item/weapon/storage/firstaid/toxin{pixel_x = 3; pixel_y = 3},/obj/item/weapon/storage/firstaid/adv{pixel_x = 1},/obj/structure/window/reinforced/crescent{dir = 4},/turf/simulated/floor/tiled/dark,/area/map_template/ninja_dojo/dojo)
"aA" = (/obj/machinery/chemical_dispenser/ert,/obj/item/weapon/reagent_containers/glass/beaker/large,/turf/simulated/floor/tiled/dark,/area/map_template/ninja_dojo/dojo)
"aB" = (/obj/effect/floor_decal/industrial/warning{dir = 1},/turf/simulated/floor/tiled/dark,/area/map_template/ninja_dojo/dojo)
"aC" = (/obj/effect/floor_decal/industrial/warning{dir = 1},/obj/item/device/radio/intercom/syndicate{dir = 8; pixel_x = 22},/turf/simulated/floor/tiled/dark,/area/map_template/ninja_dojo/dojo)
"aD" = (/turf/simulated/floor/wood/walnut,/area/map_template/ninja_dojo/dojo)
"aE" = (/obj/effect/landmark{name = "ninjastart"},/turf/simulated/floor/carpet,/area/map_template/ninja_dojo/dojo)
"aF" = (/obj/effect/landmark{name = "ninjastart"},/turf/simulated/floor/carpet/blue2,/area/map_template/ninja_dojo/dojo)
"aG" = (/turf/simulated/floor/carpet/blue2,/area/map_template/ninja_dojo/dojo)
"aH" = (/obj/structure/iv_drip,/obj/structure/window/reinforced/crescent,/turf/simulated/floor/tiled/dark,/area/map_template/ninja_dojo/dojo)
"aI" = (/obj/structure/table/glass,/obj/item/weapon/storage/firstaid/regular,/obj/item/weapon/storage/firstaid/combat,/obj/structure/window/reinforced/crescent{dir = 4},/obj/structure/window/reinforced/crescent,/turf/simulated/floor/tiled/dark,/area/map_template/ninja_dojo/dojo)
"aJ" = (/obj/effect/floor_decal/spline/fancy/wood/corner,/turf/simulated/floor/tiled/white,/area/map_template/ninja_dojo/dojo)
"aK" = (/obj/effect/floor_decal/spline/fancy/wood,/turf/simulated/floor/tiled/white,/area/map_template/ninja_dojo/dojo)
"aL" = (/obj/effect/floor_decal/spline/fancy/wood,/obj/machinery/chemical_dispenser/full,/obj/item/weapon/reagent_containers/glass/beaker/large,/turf/simulated/floor/tiled/dark,/area/map_template/ninja_dojo/dojo)
"aM" = (/obj/machinery/door/morgue{dir = 2; name = "Teleporter"},/turf/simulated/floor/tiled/dark,/area/map_template/ninja_dojo/dojo)
"aN" = (/obj/machinery/door/morgue{dir = 2; name = "Teleporter"},/turf/simulated/floor/wood/walnut,/area/map_template/ninja_dojo/dojo)
"aO" = (/obj/machinery/sleeper{dir = 4},/turf/simulated/floor/tiled/dark,/area/map_template/ninja_dojo/dojo)
"aP" = (/turf/simulated/floor/tiled/dark,/area/map_template/ninja_dojo/dojo)
"aQ" = (/obj/machinery/chem_master,/turf/simulated/floor/tiled/white,/area/map_template/ninja_dojo/dojo)
"aR" = (/obj/effect/floor_decal/spline/fancy/wood{dir = 4},/turf/simulated/floor/tiled/white,/area/map_template/ninja_dojo/dojo)
"aS" = (/obj/structure/flora/pottedplant/bamboo,/turf/simulated/floor/wood/walnut,/area/map_template/ninja_dojo/dojo)
"aT" = (/obj/structure/flora/pottedplant/orientaltree,/turf/simulated/floor/wood/walnut,/area/map_template/ninja_dojo/dojo)
"aU" = (/obj/machinery/door/morgue{dir = 2; name = "Medical"},/turf/simulated/floor/wood/walnut,/area/map_template/ninja_dojo/dojo)
"aV" = (/obj/item/device/radio/intercom/syndicate{dir = 1; pixel_y = -28},/turf/simulated/floor/wood/walnut,/area/map_template/ninja_dojo/dojo)
"aW" = (/obj/machinery/door/morgue{dir = 2; name = "Dojo"},/turf/simulated/floor/wood/maple,/area/map_template/ninja_dojo/dojo)
"aX" = (/obj/machinery/bodyscanner{dir = 8},/turf/simulated/floor/tiled/dark,/area/map_template/ninja_dojo/dojo)
"aY" = (/obj/machinery/body_scanconsole{dir = 8},/turf/simulated/floor/tiled/dark,/area/map_template/ninja_dojo/dojo)
"aZ" = (/obj/effect/floor_decal/spline/fancy/wood{dir = 6},/turf/simulated/floor/tiled/white,/area/map_template/ninja_dojo/dojo)
"ba" = (/obj/structure/table/rack,/obj/item/weapon/storage/belt/medical,/obj/item/device/scanner/health,/turf/simulated/floor/wood/walnut,/area/map_template/ninja_dojo/dojo)
"bb" = (/obj/machinery/door/unpowered/simple/wood,/turf/simulated/floor/wood/walnut,/area/map_template/ninja_dojo/dojo)
"bc" = (/obj/structure/table/rack,/obj/item/clothing/accessory/storage/white_vest,/obj/item/device/radio/intercom/syndicate{dir = 8; pixel_x = 22},/turf/simulated/floor/wood/walnut,/area/map_template/ninja_dojo/dojo)
"bd" = (/obj/effect/floor_decal/asteroid,/turf/simulated/floor/snow,/area/map_template/ninja_dojo/dojo)
"be" = (/turf/simulated/floor/snow,/area/map_template/ninja_dojo/dojo)
"bf" = (/obj/effect/floor_decal/snow,/turf/simulated/floor/tiled/dark,/area/map_template/ninja_dojo/dojo)
"bg" = (/obj/structure/table/rack,/obj/item/toy/katana{name = "practice katana"},/turf/simulated/floor/wood/maple,/area/map_template/ninja_dojo/dojo)
"bh" = (/obj/structure/table/rack,/obj/item/weapon/defibrillator/compact/combat/loaded,/turf/simulated/floor/wood/walnut,/area/map_template/ninja_dojo/dojo)
"bi" = (/obj/effect/floor_decal/snow,/turf/simulated/floor/snow,/area/map_template/ninja_dojo/dojo)
"bj" = (/obj/structure/flora/tree/dead,/turf/simulated/floor/snow,/area/map_template/ninja_dojo/dojo)
"bk" = (/obj/structure/flora/ausbushes/palebush,/turf/simulated/floor/snow,/area/map_template/ninja_dojo/dojo)
"bl" = (/obj/structure/table/woodentable/walnut,/obj/machinery/chemical_dispenser/bar_soft/full,/turf/simulated/floor/wood/walnut,/area/map_template/ninja_dojo/dojo)
"bm" = (/obj/structure/table/woodentable/walnut,/obj/machinery/microwave,/turf/simulated/floor/wood/walnut,/area/map_template/ninja_dojo/dojo)
"bn" = (/obj/structure/table/woodentable/walnut,/obj/item/weapon/storage/box/glasses,/obj/item/weapon/storage/box/sinpockets{pixel_x = 5},/turf/simulated/floor/wood/walnut,/area/map_template/ninja_dojo/dojo)
"bo" = (/obj/structure/undies_wardrobe,/turf/simulated/floor/wood/walnut,/area/map_template/ninja_dojo/dojo)
"bp" = (/obj/structure/bookcase,/turf/simulated/floor/wood/walnut,/area/map_template/ninja_dojo/dojo)
"bq" = (/obj/structure/flora/pottedplant/flower,/turf/simulated/floor/wood/walnut,/area/map_template/ninja_dojo/dojo)
"br" = (/obj/effect/landmark/start{name = "Ninja"},/turf/simulated/floor/carpet/blue2,/area/map_template/ninja_dojo/dojo)
"bs" = (/obj/structure/table/woodentable/walnut,/obj/item/device/flashlight/lamp,/turf/simulated/floor/wood/walnut,/area/map_template/ninja_dojo/dojo)
"bt" = (/turf/simulated/floor/carpet,/area/map_template/ninja_dojo/dojo)
"bu" = (/obj/effect/floor_decal/snow,/turf/unsimulated/floor{icon_state = "freezerfloor"; dir = 2},/area/map_template/ninja_dojo/dojo)
"bv" = (/turf/unsimulated/floor{icon_state = "freezerfloor"; dir = 2},/area/map_template/ninja_dojo/dojo)
"bw" = (/obj/machinery/door/morgue{dir = 2; name = "Sleeping Chamber"},/turf/simulated/floor/wood/walnut,/area/map_template/ninja_dojo/dojo)
"bx" = (/obj/structure/bed/padded,/obj/item/weapon/bedsheet/brown,/turf/simulated/floor/wood/walnut,/area/map_template/ninja_dojo/dojo)
"by" = (/obj/effect/floor_decal/snow,/turf/simulated/floor/tiled/freezer,/area/map_template/ninja_dojo/dojo)
"bz" = (/obj/effect/floor_decal/snow,/turf/simulated/floor/ice,/area/map_template/ninja_dojo/dojo)
"bA" = (/obj/structure/table/woodentable/walnut,/obj/item/clothing/shoes/sandal,/obj/item/clothing/mask/balaclava,/turf/simulated/floor/wood/walnut,/area/map_template/ninja_dojo/dojo)
"bB" = (/obj/structure/table/woodentable/walnut,/obj/item/weapon/reagent_containers/food/snacks/soylentgreen,/turf/simulated/floor/wood/walnut,/area/map_template/ninja_dojo/dojo)
"bC" = (/obj/structure/table/woodentable/walnut,/obj/item/toy/figure/wizard,/obj/item/device/radio/intercom/syndicate{dir = 1; pixel_y = -28},/turf/simulated/floor/wood/walnut,/area/map_template/ninja_dojo/dojo)
"bD" = (/obj/machinery/door/morgue{dir = 2; name = "Bath"},/turf/simulated/floor/tiled/freezer,/area/map_template/ninja_dojo/dojo)
"bE" = (/turf/simulated/floor/tiled/freezer,/area/map_template/ninja_dojo/dojo)
"bF" = (/obj/effect/floor_decal/spline/fancy/wood/corner,/obj/item/device/radio/intercom/syndicate{dir = 4; pixel_x = -22},/turf/simulated/floor/tiled/freezer,/area/map_template/ninja_dojo/dojo)
"bG" = (/obj/item/weapon/storage/mirror{dir = 4; icon_state = "mirror"; pixel_x = -1; pixel_y = 40},/obj/structure/hygiene/sink{dir = 1; pixel_y = 27},/turf/simulated/floor/tiled/freezer,/area/map_template/ninja_dojo/dojo)
"bH" = (/obj/structure/hygiene/toilet{pixel_y = 15},/turf/simulated/floor/tiled/freezer,/area/map_template/ninja_dojo/dojo)
"bI" = (/obj/structure/bookcase{name = "bookcase (Tactics)"},/turf/simulated/floor/wood/walnut,/area/map_template/ninja_dojo/dojo)
"bJ" = (/obj/structure/flora/pottedplant/shoot,/turf/simulated/floor/wood/walnut,/area/map_template/ninja_dojo/dojo)
"bK" = (/obj/structure/bookcase{name = "bookcase (Religious)"},/turf/simulated/floor/wood/walnut,/area/map_template/ninja_dojo/dojo)
"bL" = (/turf/simulated/floor/plating{icon = 'icons/turf/snow.dmi'; icon_state = "snowplating"},/area/map_template/ninja_dojo/dojo)
"bM" = (/obj/effect/floor_decal/spline/fancy/wood/corner,/turf/simulated/floor/tiled/freezer,/area/map_template/ninja_dojo/dojo)
"bN" = (/obj/effect/floor_decal/spline/fancy/wood,/turf/simulated/floor/tiled/freezer,/area/map_template/ninja_dojo/dojo)
"bO" = (/obj/structure/flora/tree/pine,/turf/simulated/floor/snow,/area/map_template/ninja_dojo/dojo)
"bP" = (/obj/effect/floor_decal/spline/fancy/wood{dir = 4},/turf/simulated/floor/tiled/freezer,/area/map_template/ninja_dojo/dojo)
"bQ" = (/turf/simulated/floor/beach/water/ocean{icon_state = "seashallow"},/area/map_template/ninja_dojo/dojo)
"bR" = (/obj/effect/floor_decal/industrial/warning,/turf/simulated/floor/tiled/dark,/area/map_template/ninja_dojo/dojo)
"bS" = (/obj/item/device/radio/intercom/syndicate{dir = 4; pixel_x = -22},/turf/simulated/floor/wood/walnut,/area/map_template/ninja_dojo/dojo)
"bT" = (/obj/effect/floor_decal/snow,/turf/simulated/floor/plating{icon = 'icons/turf/snow.dmi'; icon_state = "snowplating"},/area/map_template/ninja_dojo/dojo)
"bU" = (/obj/machinery/door/morgue{dir = 2; name = "Equipment"},/turf/simulated/floor/tiled/dark,/area/map_template/ninja_dojo/dojo)
"bV" = (/obj/structure/table/rack,/obj/item/clothing/accessory/storage/brown_vest,/obj/effect/floor_decal/industrial/outline/grey,/turf/simulated/floor/tiled/dark,/area/map_template/ninja_dojo/dojo)
"bW" = (/obj/structure/table/rack,/obj/item/weapon/storage/belt/utility/full,/obj/item/device/multitool,/obj/effect/floor_decal/industrial/outline/grey,/turf/simulated/floor/tiled/dark,/area/map_template/ninja_dojo/dojo)
"bX" = (/obj/structure/table/steel_reinforced,/obj/item/device/multitool/hacktool,/obj/effect/floor_decal/industrial/outline/grey,/turf/simulated/floor/tiled/dark,/area/map_template/ninja_dojo/dojo)
"bY" = (/obj/effect/floor_decal/industrial/outline/grey,/obj/machinery/portable_atmospherics/canister/oxygen,/turf/simulated/floor/tiled/dark,/area/map_template/ninja_dojo/dojo)
"bZ" = (/obj/effect/paint/dark_gunmetal,/turf/simulated/wall/titanium,/area/map_template/ninja_dojo/start)
"ca" = (/obj/effect/floor_decal/industrial/warning{dir = 8},/turf/simulated/floor/tiled/dark,/area/map_template/ninja_dojo/dojo)
"cb" = (/obj/machinery/door/airlock/centcom{name = "Equipment"},/turf/simulated/floor/tiled/dark,/area/map_template/ninja_dojo/dojo)
"cc" = (/obj/machinery/acting/changer,/obj/effect/floor_decal/industrial/outline/grey,/turf/simulated/floor/tiled/dark,/area/map_template/ninja_dojo/dojo)
"cd" = (/obj/structure/table/rack,/obj/item/stack/nanopaste,/obj/item/stack/nanopaste,/obj/effect/floor_decal/industrial/outline/grey,/turf/simulated/floor/tiled/dark,/area/map_template/ninja_dojo/dojo)
"ce" = (/obj/machinery/fabricator{desc = "Your typical Autolathe. It appears to have much more options than your regular one, however..."; fab_status_flags = 1; name = "unlocked autolathe"},/obj/effect/floor_decal/industrial/outline/grey,/turf/simulated/floor/tiled/dark,/area/map_template/ninja_dojo/dojo)
"cf" = (/obj/structure/table/rack,/obj/item/stack/material/steel{amount = 50},/obj/item/stack/material/steel{amount = 50},/obj/item/stack/material/glass{amount = 50},/obj/item/stack/material/glass{amount = 50},/obj/effect/floor_decal/industrial/outline/grey,/turf/simulated/floor/tiled/dark,/area/map_template/ninja_dojo/dojo)
"cg" = (/obj/structure/table/steel_reinforced,/obj/item/weapon/storage/secure/briefcase/money,/obj/effect/floor_decal/industrial/outline/grey,/turf/simulated/floor/tiled/dark,/area/map_template/ninja_dojo/dojo)
"ch" = (/obj/structure/table/steel_reinforced,/obj/machinery/cell_charger,/obj/effect/floor_decal/industrial/outline/grey,/obj/item/clothing/accessory/storage/bandolier,/turf/simulated/floor/tiled/dark,/area/map_template/ninja_dojo/dojo)
"ci" = (/obj/structure/table/steel_reinforced,/obj/machinery/recharger,/obj/effect/floor_decal/industrial/outline/grey,/turf/simulated/floor/tiled/dark,/area/map_template/ninja_dojo/dojo)
"cj" = (/obj/structure/table/rack,/obj/item/weapon/material/star/ninja,/obj/item/weapon/material/star/ninja,/obj/item/weapon/material/star/ninja,/obj/item/weapon/material/star/ninja,/obj/item/weapon/material/star/ninja,/obj/item/weapon/material/star/ninja,/obj/effect/floor_decal/industrial/outline/grey,/turf/simulated/floor/tiled/dark,/area/map_template/ninja_dojo/dojo)
"ck" = (/obj/structure/table/rack,/obj/item/weapon/material/star,/obj/item/weapon/material/star,/obj/item/weapon/material/star,/obj/item/weapon/material/star,/obj/item/weapon/material/star,/obj/item/weapon/material/star,/obj/effect/floor_decal/industrial/outline/grey,/turf/simulated/floor/tiled/dark,/area/map_template/ninja_dojo/dojo)
"cl" = (/obj/structure/table/rack,/obj/item/clothing/accessory/storage/black_vest,/obj/effect/floor_decal/industrial/outline/grey,/turf/simulated/floor/tiled/dark,/area/map_template/ninja_dojo/dojo)
"cm" = (/obj/structure/table/rack,/obj/item/weapon/storage/belt/holster/security/tactical,/obj/effect/floor_decal/industrial/outline/grey,/turf/simulated/floor/tiled/dark,/area/map_template/ninja_dojo/dojo)
"cn" = (/obj/structure/table/steel_reinforced,/obj/item/weapon/plastique,/obj/item/weapon/plastique,/obj/item/device/radio/intercom/syndicate{dir = 1; pixel_y = -28},/obj/effect/floor_decal/industrial/outline/grey,/turf/simulated/floor/tiled/dark,/area/map_template/ninja_dojo/dojo)
"co" = (/obj/structure/table/steel_reinforced,/obj/item/weapon/storage/box/anti_photons,/obj/effect/floor_decal/industrial/outline/grey,/turf/simulated/floor/tiled/dark,/area/map_template/ninja_dojo/dojo)
"cp" = (/obj/effect/paint/dark_gunmetal,/turf/simulated/wall/r_titanium,/area/map_template/ninja_dojo/start)
"cq" = (/obj/structure/shuttle/engine/propulsion{icon_state = "propulsion"; dir = 1},/obj/effect/paint/dark_gunmetal,/turf/simulated/wall/r_titanium,/area/map_template/ninja_dojo/start)
"cr" = (/obj/effect/floor_decal/industrial/warning{icon_state = "warning"; dir = 4},/obj/structure/table/rack,/obj/machinery/light/halogen{icon_state = "tube_map"; dir = 1},/turf/simulated/floor/tiled/techfloor,/area/map_template/ninja_dojo/start)
"cs" = (/obj/machinery/computer/teleporter,/turf/simulated/floor/tiled/techfloor/grid,/area/map_template/ninja_dojo/start)
"ct" = (/obj/machinery/teleport/station,/turf/simulated/floor/tiled/techfloor/grid,/area/map_template/ninja_dojo/start)
"cu" = (/obj/machinery/teleport/hub,/obj/effect/floor_decal/industrial/hatch/yellow,/turf/simulated/floor/tiled/techfloor/grid,/area/map_template/ninja_dojo/start)
"cv" = (/obj/machinery/atmospherics/portables_connector,/obj/effect/floor_decal/industrial/outline/yellow,/obj/machinery/portable_atmospherics/canister/air/airlock,/obj/effect/floor_decal/industrial/warning{icon_state = "warning"; dir = 8},/obj/machinery/light/halogen{icon_state = "tube_map"; dir = 1},/turf/simulated/floor/tiled/techfloor,/area/map_template/ninja_dojo/start)
"cw" = (/obj/effect/floor_decal/industrial/outline/grey,/obj/structure/bed/chair/shuttle/black{icon_state = "shuttle_chair_preview"; dir = 4},/turf/simulated/floor/tiled/techfloor,/area/map_template/ninja_dojo/start)
"cx" = (/obj/structure/closet/medical_wall/filled/regular{pixel_y = 32},/turf/simulated/floor/tiled/techfloor,/area/map_template/ninja_dojo/start)
"cy" = (/obj/effect/floor_decal/industrial/warning/corner{icon_state = "warningcorner"; dir = 4},/turf/simulated/floor/tiled/techfloor,/area/map_template/ninja_dojo/start)
"cz" = (/obj/effect/floor_decal/industrial/warning{dir = 1},/turf/simulated/floor/tiled/techfloor,/area/map_template/ninja_dojo/start)
"cA" = (/obj/effect/floor_decal/industrial/warning/corner{dir = 1},/obj/machinery/atmospherics/pipe/simple/hidden,/turf/simulated/floor/tiled/techfloor,/area/map_template/ninja_dojo/start)
"cB" = (/obj/machinery/embedded_controller/radio/airlock/docking_port{frequency = 1331; id_tag = "ninja_shuttle"; pixel_x = 0; pixel_y = 28; req_access = list("ACCESS_SYNDICATE")},/obj/machinery/light/halogen{icon_state = "tube_map"; dir = 8},/turf/simulated/floor/tiled/techfloor/grid,/area/map_template/ninja_dojo/start)
"cC" = (/obj/machinery/door/airlock/external{autoset_access = 0; density = 1; frequency = 1331; id_tag = "ninja_shuttle_outer"; name = "Ship External Access"; req_access = list("ACCESS_SYNDICATE")},/obj/machinery/door/blast/regular{density = 0; icon_state = "pdoor0"; id_tag = "ninjadoor"; name = "Blast Door"; opacity = 0},/turf/simulated/floor/tiled/techfloor/grid,/area/map_template/ninja_dojo/start)
"cD" = (/obj/machinery/sleeper{dir = 4},/obj/effect/floor_decal/industrial/outline/grey,/turf/simulated/floor/tiled/techfloor,/area/map_template/ninja_dojo/start)
"cE" = (/obj/item/device/radio/intercom/syndicate{dir = 1; pixel_y = -28},/turf/simulated/floor/tiled/techfloor,/area/map_template/ninja_dojo/start)
"cF" = (/turf/simulated/floor/tiled/techfloor,/area/map_template/ninja_dojo/start)
"cG" = (/obj/effect/shuttle_landmark/ninja/start,/turf/simulated/floor/tiled/techfloor,/area/map_template/ninja_dojo/start)
"cH" = (/obj/machinery/atmospherics/pipe/simple/hidden{dir = 5; icon_state = "intact"},/obj/machinery/access_button{command = "cycle_interior"; frequency = 1331; master_tag = "ninja_shuttle"; name = "interior access button"; pixel_x = 25; pixel_y = 25; req_access = list("ACCESS_SYNDICATE")},/turf/simulated/floor/tiled/techfloor,/area/map_template/ninja_dojo/start)
"cI" = (/obj/machinery/atmospherics/pipe/simple/hidden{dir = 4},/obj/machinery/door/airlock/external{autoset_access = 0; frequency = 1331; id_tag = "ninja_shuttle_inner"; name = "Ship External Access"; req_access = list("ACCESS_SYNDICATE")},/turf/simulated/floor/tiled/techfloor/grid,/area/map_template/ninja_dojo/start)
"cJ" = (/obj/machinery/airlock_sensor{frequency = 1331; id_tag = "ninja_shuttle_sensor"; pixel_x = 8; pixel_y = -25},/obj/machinery/atmospherics/unary/vent_pump/high_volume/shuttle{dir = 8; id_tag = "ninja_shuttle_pump"},/obj/machinery/button/blast_door{id_tag = "ninjadoor"; name = "remote shutter control"; pixel_x = 25},/turf/simulated/floor/tiled/techfloor/grid,/area/map_template/ninja_dojo/start)
"cK" = (/obj/structure/closet,/obj/effect/floor_decal/industrial/outline/grey,/turf/simulated/floor/tiled/techfloor,/area/map_template/ninja_dojo/start)
"cL" = (/obj/effect/floor_decal/industrial/outline/grey,/obj/machinery/newscaster{pixel_x = 30},/obj/machinery/portable_atmospherics/canister/oxygen,/turf/simulated/floor/tiled/techfloor,/area/map_template/ninja_dojo/start)
"cM" = (/obj/structure/table/steel_reinforced,/obj/machinery/cell_charger,/obj/item/weapon/screwdriver,/obj/effect/floor_decal/industrial/outline/grey,/obj/machinery/light/halogen{icon_state = "tube_map"; dir = 8},/turf/simulated/floor/tiled/techfloor,/area/map_template/ninja_dojo/start)
"cN" = (/obj/structure/bed/chair/shuttle/black,/turf/simulated/floor/tiled/techfloor,/area/map_template/ninja_dojo/start)
"cO" = (/obj/machinery/button/windowtint{pixel_x = 24; pixel_y = -24},/obj/machinery/button/blast_door{id_tag = "ninjawindow"; name = "remote shutter control"; pixel_x = 36; pixel_y = -24},/turf/simulated/floor/tiled/techfloor,/area/map_template/ninja_dojo/start)
"cP" = (/obj/structure/table/steel_reinforced,/obj/machinery/recharger,/obj/item/weapon/wrench,/obj/effect/floor_decal/industrial/outline/grey,/obj/machinery/light/halogen{icon_state = "tube_map"; dir = 4},/turf/simulated/floor/tiled/techfloor,/area/map_template/ninja_dojo/start)
"cQ" = (/obj/machinery/computer/station_alert/all{dir = 1},/obj/effect/floor_decal/industrial/outline/grey,/turf/simulated/floor/tiled/techfloor,/area/map_template/ninja_dojo/start)
"cR" = (/obj/machinery/computer/shuttle_control/multi/ninja{dir = 1},/obj/effect/floor_decal/industrial/outline/grey,/turf/simulated/floor/tiled/techfloor,/area/map_template/ninja_dojo/start)
"cS" = (/obj/machinery/computer/modular/preset/security{dir = 1},/obj/effect/floor_decal/industrial/outline/grey,/turf/simulated/floor/tiled/techfloor,/area/map_template/ninja_dojo/start)
"cT" = (/obj/effect/wallframe_spawn/reinforced/polarized/full,/obj/machinery/door/blast/regular{density = 1; icon_state = "pdoor1"; id_tag = "ninjawindow"; name = "Blast Shutter"; opacity = 1},/obj/effect/paint/dark_gunmetal,/turf/simulated/floor/plating,/area/map_template/ninja_dojo/start)

(1,1,1) = {"
aaaaaaaaaaaaaaaaaaaaaaaaaaaaaaaaaaaaaaaaaaaaaaaaaaaaaaaaaaaaaaaaaaaaaaaaaaaaaaaaaaaaaaaa
aaababababababababababababababababababababababababababababababababababababababababababaa
aaababababababababacacacacacacacacacacacacacacacacacacacacacacacacacacacacababababababaa
aaababababababacacacacacacacacacacacacacacacacacacacacacacacacacacacacacacababababababaa
aaababababacacacacacacacacacacacacacacacacacacacacacacacacacacacacacacacacacacababababaa
aaababababacacadadadadadadadadadacacacacacacacacacacacacacacacacacacacacacacacababababaa
aaabababacacacadaeafagahaiajakadadadadadacacacacadadadadadadalalalaladadacacacacabababaa
aaababacacacacadamananaoapaqaradasatauadacacacacadavawavadaxaxaxaxaxaxadacacacacacababaa
aaabacacacacacadayananazananaAadaBaBaCadacacacacadaDaEaDadaxaFaGaGaGaxalacacacacacacabaa
aaabacacacacacadaHananaIaJaKaLadalaMaladalalalaladalaNaladaxaGaGaGaGaxalacacacacacacabaa
aaabacacacacacadaOaPanaQaRaDaSalaTaDaDaDaDaDaDaDaDaDaDaTalaxaGaGaGaGaxalacacacacacacabaa
aaabacacacacacadaPaPananaRaDaDaUaDaDaDaVaDaDaDaDaDaDaDaVaWaxaGaGaGaFaxalacacacacacacabaa
aaabacacacacacadaXaYaKaKaZaDbaadadalaladadbbbbadadalaladadaxaxaxaxaxaxadacacacacacacabaa
aaabacacacacacadadadaDaDaDaDbcadacbdbebebeaPbfbeacacacacadaWaladbgbgbgadacacacacacacabaa
aaabacacacacacacacadaDaDaDaDbhadacbiaPbfaPaPaPaPaPbfbeacadaDaTadadadadadadacacacacacabaa
aaabacacacacacacadadalaUaUaladadacaPbjaPbebdbebeaPbkaPacalaDaDadblbmbnboalalacacacacabaa
aaabacacacacacacadbpaTaDaDbqbpadacaPaPbebebebebebeaPaPbealaDaDalaDaGaGbrbsalacacacacabaa
aaabacacacacacacalaDbtbtbtbtaDalbeaPbebebebubvbibebebfbeadaDaDbwaDaGaGaFbxalacacacacabaa
aaabacacacacacacalaDbtbtbtbtaDbbaPaPbebebybzbzbybebebfaPbbaDaDadaDbAbBbCalalacacacacabaa
aaabacacacacacacalaDbtbtbtbtaDbbaPbfbebebybzbzbybebeaPaPbbaDaDadbDadadadadacacacacacabaa
aaabacacacacacacalaDbtbtbtbtaDalbebfbebebibEbybibebeaPbeadaDaDadbFbGbHadacacacacacacabaa
aaabacacacacacacadbIbJaDaDaSbKadbeaPbLbebebebebebebLaPbealaDaDadbMbNbNadacacacacacacabaa
aaabacacacacacacadadalbbbbaladadacbfbObLbebebebebLbjbfbdadaDaDadbPbQbQadacacacacacacabaa
aaabacacacacacacacacacbRbRbebebeacbeaPaPaPbfbfaPaPaPbebeadbSaDadbPbQbQadacacacacacacabaa
aaabbLbLbLbTbTbTbLbLbLbLbLbLbLbTacacacacbeaPbfbebebebebeadbUbUadadadadadacacacacacacabaa
aaabbLbTbLbLbLbLbLbLbLbLbLbLbLbLbebebebebeaPaPadadadadadadaPaPbVbWbXbYadadacacacacacabaa
aaabbLbTbLbLbZbLbLbLbZbLbLbTbLbLcabfaPaPaPbfaPcbaPaPaPaPaPaPaPaPaPaPaPccadacacacacacabaa
aaabbTbLbLbLbZbTbTbLbZbLbLbTbLbLcaaPbfaPbfaPaPcbaPaPaPaPaPaPaPaPaPaPaPcdadacacacacacabaa
aaabbTbLbLbLbZbLbTbLbZbLbLbLbLbTbebebebebebebeadcecfcgchcicjckclcmcncoadadacacacacacabaa
aaabbLbLbLbLbZbLbLbLbZbLbLbLbLbLacacacacacacacadadadadadadadadadadadadadacacacacacacabaa
aaabbLbLcpcqcpcpcpcpcpcqcpbLbLbLacacacacacacacacacacacacacacacacacacacacacacacacacacabaa
aaabbLcpcpcpcrcsctcucvcpcpcpbLbLacacacacacacacacacacacacacacacacacacacacacacacacacacabaa
aaabbLcpcwcxcyczczczcAcpcBcCbLbLacacacacacacacacacacacacacacacacacacacacacacacacacababaa
aaabbTcpcDcEcFcFcGcFcHcIcJcpbLbTacacacacacacacacacacacacacacacacacacacacacacacacacababaa
aaabbLcpcpcpcKcFcFcFcLcpcpcpbLbTacacacacacacacacacacacacacacacacacacacacacacacacabababaa
aaabbLbLcpcpcMcFcNcOcPcpcpbLbTbTacacacacacacacacacacacacacacacacacacacacacacacababababaa
aaabbTbLbLcpcpcQcRcScpcpbLbLbTbLacacacacacacacacacacacacacacacacacacacacacacacababababaa
aaabbTbTbLbLcpcTcTcTcpbLbLbLbLbLacacacacacacacacacacacacacacacacacacacacacababababababaa
aaabbTbLbLbLbLbLbLbLbLbLbLbLbLbLacacacacacacacacacacacacacacacacacacacacabababababababaa
aaababababababababababababababababababababababababababababababababababababababababababaa
aaaaaaaaaaaaaaaaaaaaaaaaaaaaaaaaaaaaaaaaaaaaaaaaaaaaaaaaaaaaaaaaaaaaaaaaaaaaaaaaaaaaaaaa
"}
