//MAP CONVERTED BY dmm2tgm.py THIS HEADER COMMENT PREVENTS RECONVERSION, DO NOT REMOVE
"aa" = (
/turf/space/bluespace,
/area/space)
"ab" = (
/turf/unsimulated/wall,
/area/map_template/wizard_station)
"ac" = (
/turf/unsimulated/wall/fakeglass{
	dir = 8;
	icon_state = "fakewindows"
	},
/area/map_template/wizard_station)
"ad" = (
/turf/unsimulated/wall/fakeglass{
	dir = 8;
	icon_state = "fakewindows2"
	},
/area/map_template/wizard_station)
"ae" = (
/turf/unsimulated/wall/fakeglass{
	dir = 4
	},
/area/map_template/wizard_station)
"af" = (
/obj/structure/table/woodentable/walnut,
/obj/item/device/flashlight/lamp/green{
	on = 0;
	pixel_x = -3;
	pixel_y = 8
	},
/obj/item/reagent_containers/food/drinks/flask/barflask,
/turf/simulated/floor/carpet,
/area/map_template/wizard_station)
"ag" = (
/obj/structure/bed/padded,
/obj/item/bedsheet/rd,
/turf/simulated/floor/carpet,
/area/map_template/wizard_station)
"ah" = (
/obj/structure/table/woodentable/walnut,
/obj/item/storage/backpack/satchel/grey/withwallet,
/obj/item/clothing/glasses/monocle,
/turf/simulated/floor/carpet,
/area/map_template/wizard_station)
"ai" = (
/obj/structure/table/woodentable/walnut,
/obj/effect/landmark{
	name = "Teleport-Scroll"
	},
/obj/item/toy/figure/ninja,
/turf/simulated/floor/carpet,
/area/map_template/wizard_station)
"aj" = (
/obj/effect/landmark/start{
	name = "Wizard"
	},
/obj/effect/landmark/start{
	name = "wizard"
	},
/turf/simulated/floor/carpet,
/area/map_template/wizard_station)
"ak" = (
/obj/structure/aliumizer,
/turf/simulated/floor/carpet,
/area/map_template/wizard_station)
"al" = (
/obj/structure/table/woodentable/walnut,
/obj/item/storage/backpack/cultpack,
/turf/simulated/floor/carpet,
/area/map_template/wizard_station)
"am" = (
/turf/simulated/floor/carpet,
/area/map_template/wizard_station)
"an" = (
/obj/structure/table/woodentable/walnut,
/obj/item/storage/backpack/satchel/leather,
/turf/simulated/floor/carpet,
/area/map_template/wizard_station)
"ao" = (
/obj/structure/undies_wardrobe,
/turf/simulated/floor/carpet,
/area/map_template/wizard_station)
"ap" = (
/obj/machinery/door/unpowered/simple/wood,
/turf/simulated/floor/carpet,
/area/map_template/wizard_station)
"aq" = (
/obj/structure/bookcase{
	name = "Forbidden Knowledge"
	},
/obj/effect/decal/cleanable/cobweb,
/turf/unsimulated/floor{
	dir = 8;
	icon_state = "wood"
	},
/area/map_template/wizard_station)
"ar" = (
/obj/structure/table/woodentable/walnut,
/turf/unsimulated/floor{
	dir = 8;
	icon_state = "wood"
	},
/area/map_template/wizard_station)
"as" = (
/turf/unsimulated/floor{
	dir = 8;
	icon_state = "wood"
	},
/area/map_template/wizard_station)
"at" = (
/obj/structure/table/woodentable/walnut,
/obj/item/storage/pill_bottle/dice_nerd,
/turf/unsimulated/floor{
	dir = 8;
	icon_state = "wood"
	},
/area/map_template/wizard_station)
"au" = (
/obj/structure/bookcase{
	name = "bookcase (Tactics)"
	},
/turf/unsimulated/floor{
	dir = 8;
	icon_state = "wood"
	},
/area/map_template/wizard_station)
"av" = (
/obj/structure/bookcase{
	name = "Forbidden Knowledge"
	},
/turf/unsimulated/floor{
	dir = 8;
	icon_state = "wood"
	},
/area/map_template/wizard_station)
"aw" = (
/turf/unsimulated/wall/fakeglass{
	dir = 1;
	icon_state = "fakewindows"
	},
/area/map_template/wizard_station)
"ax" = (
/turf/unsimulated/floor{
	dir = 2;
	icon = 'icons/misc/beach.dmi';
	icon_state = "seashallow";
	name = "water"
	},
/area/map_template/wizard_station)
"ay" = (
/obj/item/bikehorn/rubberducky,
/turf/unsimulated/floor{
	dir = 2;
	icon = 'icons/misc/beach.dmi';
	icon_state = "seashallow";
	name = "water"
	},
/area/map_template/wizard_station)
"az" = (
/obj/effect/floor_decal/spline/fancy/wood{
	dir = 8
	},
/turf/unsimulated/floor{
	dir = 2;
	icon_state = "freezerfloor"
	},
/area/map_template/wizard_station)
"aA" = (
/obj/structure/hygiene/toilet{
	pixel_y = 8
	},
/turf/unsimulated/floor{
	dir = 2;
	icon_state = "freezerfloor"
	},
/area/map_template/wizard_station)
"aB" = (
/obj/structure/bed/chair/wood/wings/walnut{
	dir = 4;
	icon_state = "wooden_chair_wings"
	},
/turf/unsimulated/floor{
	dir = 8;
	icon_state = "wood"
	},
/area/map_template/wizard_station)
"aC" = (
/obj/structure/table/woodentable/walnut,
/obj/item/reagent_containers/food/snacks/chawanmushi,
/turf/unsimulated/floor{
	dir = 8;
	icon_state = "wood"
	},
/area/map_template/wizard_station)
"aD" = (
/obj/structure/bed/chair/wood/wings/walnut{
	dir = 8;
	icon_state = "wooden_chair_wings"
	},
/turf/unsimulated/floor{
	dir = 8;
	icon_state = "wood"
	},
/area/map_template/wizard_station)
"aE" = (
/obj/structure/table/woodentable/walnut,
/obj/item/storage/box/cups,
/turf/unsimulated/floor{
	dir = 8;
	icon_state = "wood"
	},
/area/map_template/wizard_station)
"aF" = (
/obj/structure/closet/cabinet,
/obj/item/clothing/suit/wizrobe/red,
/obj/item/clothing/shoes/sandal,
/obj/item/clothing/head/wizard/red,
/obj/item/staff,
/turf/unsimulated/floor{
	icon_state = "lino"
	},
/area/map_template/wizard_station)
"aG" = (
/obj/structure/closet/cabinet,
/obj/item/clothing/suit/wizrobe/marisa,
/obj/item/clothing/shoes/sandal/marisa,
/obj/item/clothing/head/wizard/marisa,
/obj/item/staff/broom,
/turf/unsimulated/floor{
	icon_state = "lino"
	},
/area/map_template/wizard_station)
"aH" = (
/obj/structure/closet/cabinet,
/obj/item/clothing/suit/wizrobe/magusblue,
/obj/item/clothing/head/wizard/magus,
/obj/item/staff,
/turf/unsimulated/floor{
	icon_state = "lino"
	},
/area/map_template/wizard_station)
"aI" = (
/obj/structure/closet/cabinet,
/obj/item/reagent_containers/food/drinks/bottle/bottleofnothing,
/obj/item/reagent_containers/food/drinks/bottle/pwine,
/obj/item/reagent_containers/food/drinks/bottle/specialwhiskey,
/obj/item/reagent_containers/food/drinks/bottle/cognac,
/obj/item/staff/anime_gun,
/obj/item/staff/anime_crossbow,
/obj/item/clothingbag/costume/anime_blue,
/obj/item/clothingbag/costume/anime_white,
/turf/unsimulated/floor{
	icon_state = "lino"
	},
/area/map_template/wizard_station)
"aJ" = (
/turf/unsimulated/wall/fakeglass{
	dir = 1;
	icon_state = "fakewindows2"
	},
/area/map_template/wizard_station)
"aK" = (
/turf/unsimulated/floor{
	dir = 2;
	icon_state = "freezerfloor"
	},
/area/map_template/wizard_station)
"aL" = (
/obj/machinery/door/unpowered/simple/silver,
/turf/unsimulated/floor{
	dir = 2;
	icon_state = "freezerfloor"
	},
/area/map_template/wizard_station)
"aM" = (
/obj/structure/table/woodentable/walnut,
/obj/item/device/megaphone,
/turf/unsimulated/floor{
	dir = 8;
	icon_state = "wood"
	},
/area/map_template/wizard_station)
"aN" = (
/obj/structure/table/woodentable/walnut,
/obj/item/storage/box/donut,
/turf/unsimulated/floor{
	dir = 8;
	icon_state = "wood"
	},
/area/map_template/wizard_station)
"aO" = (
/obj/structure/table/woodentable/walnut,
/obj/item/spacecash/bundle/c1,
/turf/unsimulated/floor{
	dir = 8;
	icon_state = "wood"
	},
/area/map_template/wizard_station)
"aP" = (
/obj/machinery/door/unpowered/simple/wood,
/turf/unsimulated/floor{
	icon_state = "lino"
	},
/area/map_template/wizard_station)
"aQ" = (
/turf/unsimulated/floor{
	icon_state = "lino"
	},
/area/map_template/wizard_station)
"aR" = (
/turf/unsimulated/wall/fakeglass,
/area/map_template/wizard_station)
"aS" = (
/obj/structure/hygiene/sink{
	dir = 4;
	icon_state = "sink";
	pixel_x = 22;
	pixel_y = 0
	},
/obj/machinery/acting/changer/mirror{
	pixel_x = 26;
	pixel_y = 0
	},
/turf/unsimulated/floor{
	dir = 2;
	icon_state = "freezerfloor"
	},
/area/map_template/wizard_station)
"aT" = (
/obj/machinery/vending/magivend,
/turf/unsimulated/floor{
	dir = 8;
	icon_state = "wood"
	},
/area/map_template/wizard_station)
"aU" = (
/obj/structure/table/woodentable/walnut,
/obj/item/reagent_containers/food/snacks/milosoup,
/turf/unsimulated/floor{
	dir = 8;
	icon_state = "wood"
	},
/area/map_template/wizard_station)
"aV" = (
/obj/structure/table/woodentable/walnut,
/obj/machinery/chemical_dispenser/bar_soft/full,
/turf/unsimulated/floor{
	dir = 8;
	icon_state = "wood"
	},
/area/map_template/wizard_station)
"aW" = (
/obj/structure/closet/cabinet,
/obj/item/clothing/under/psysuit,
/obj/item/clothing/suit/wizrobe/psypurple,
/turf/unsimulated/floor{
	icon_state = "lino"
	},
/area/map_template/wizard_station)
"aX" = (
/obj/structure/closet/cabinet,
/obj/item/clothing/shoes/sandal/marisa{
	desc = "A set of fancy shoes that are as functional as they are comfortable.";
	name = "Gentlemans Shoes"
	},
/obj/item/clothing/under/gentlesuit,
/obj/item/clothing/suit/wizrobe/gentlecoat,
/obj/item/clothing/head/wizard/cap,
/obj/item/staff/gentcane,
/turf/unsimulated/floor{
	icon_state = "lino"
	},
/area/map_template/wizard_station)
"aY" = (
/obj/structure/closet/cabinet,
/obj/item/clothing/suit/wizrobe/magusred,
/obj/item/clothing/head/wizard/magus,
/obj/item/staff,
/turf/unsimulated/floor{
	icon_state = "lino"
	},
/area/map_template/wizard_station)
"aZ" = (
/obj/structure/closet/cabinet,
/obj/item/storage/briefcase,
/turf/unsimulated/floor{
	icon_state = "lino"
	},
/area/map_template/wizard_station)
"ba" = (
/obj/structure/bookcase,
/obj/item/book/manual/nuclear,
/turf/unsimulated/floor{
	dir = 8;
	icon_state = "wood"
	},
/area/map_template/wizard_station)
"bb" = (
/obj/structure/bookcase,
/obj/item/book/manual/robotics_cyborgs,
/turf/unsimulated/floor{
	dir = 8;
	icon_state = "wood"
	},
/area/map_template/wizard_station)
"bc" = (
/obj/structure/bookcase,
/turf/unsimulated/floor{
	dir = 8;
	icon_state = "wood"
	},
/area/map_template/wizard_station)
"bd" = (
/obj/structure/table/woodentable/walnut,
/obj/item/storage/bag/cash,
/turf/unsimulated/floor{
	dir = 8;
	icon_state = "wood"
	},
/area/map_template/wizard_station)
"be" = (
/obj/machinery/door/unpowered/simple/wood,
/turf/unsimulated/floor{
	dir = 8;
	icon_state = "wood"
	},
/area/map_template/wizard_station)
"bf" = (
/obj/structure/closet/coffin,
/turf/unsimulated/floor{
	icon_state = "cult";
	name = "plating"
	},
/area/map_template/wizard_station)
"bg" = (
/turf/unsimulated/floor{
	icon_state = "cult";
	name = "plating"
	},
/area/map_template/wizard_station)
"bh" = (
/obj/structure/cult/pylon,
/turf/unsimulated/floor{
	icon_state = "cult";
	name = "plating"
	},
/area/map_template/wizard_station)
"bi" = (
/obj/structure/kitchenspike,
/turf/unsimulated/floor{
	icon_state = "cult";
	name = "plating"
	},
/area/map_template/wizard_station)
"bj" = (
/obj/item/remains/human,
/turf/unsimulated/floor{
	icon_state = "lava";
	name = "plating"
	},
/area/map_template/wizard_station)
"bk" = (
/turf/unsimulated/floor{
	icon_state = "lava";
	name = "plating"
	},
/area/map_template/wizard_station)
"bl" = (
/turf/unsimulated/floor{
	icon_state = "grass0";
	name = "grass"
	},
/area/map_template/wizard_station)
"bm" = (
/obj/structure/flora/ausbushes/fullgrass,
/turf/unsimulated/floor{
	icon_state = "grass0";
	name = "grass"
	},
/area/map_template/wizard_station)
"bn" = (
/obj/structure/cult/talisman,
/obj/item/material/knife/ritual,
/turf/unsimulated/floor{
	icon_state = "cult";
	name = "plating"
	},
/area/map_template/wizard_station)
"bo" = (
/obj/effect/gateway/active/cult,
/turf/unsimulated/floor{
	icon_state = "cult";
	name = "plating"
	},
/area/map_template/wizard_station)
"bp" = (
/obj/structure/table/marble,
/obj/item/device/flashlight/slime,
/turf/unsimulated/floor{
	icon_state = "cult";
	name = "plating"
	},
/area/map_template/wizard_station)
"bq" = (
/obj/structure/flora/ausbushes/grassybush,
/turf/unsimulated/floor{
	icon_state = "grass0";
	name = "grass"
	},
/area/map_template/wizard_station)
"br" = (
/obj/structure/flora/pottedplant/unusual,
/turf/unsimulated/floor{
	icon_state = "cult";
	name = "plating"
	},
/area/map_template/wizard_station)
"bs" = (
/obj/structure/table/woodentable/walnut,
/obj/item/xenos_claw,
/turf/unsimulated/floor{
	icon_state = "cult";
	name = "plating"
	},
/area/map_template/wizard_station)
"bt" = (
/turf/unsimulated/floor{
	icon_state = "asteroid"
	},
/area/map_template/wizard_station)
"bu" = (
/obj/effect/overlay/palmtree_r,
/turf/unsimulated/floor{
	icon_state = "asteroid"
	},
/area/map_template/wizard_station)
"bv" = (
/obj/effect/overlay/coconut,
/turf/unsimulated/floor{
	icon_state = "asteroid"
	},
/area/map_template/wizard_station)

(1,1,1) = {"
aa
aa
aa
aa
aa
aa
aa
aa
aa
aa
aa
aa
aa
aa
aa
aa
aa
aa
aa
aa
aa
aa
aa
aa
aa
aa
aa
aa
aa
aa
aa
aa
aa
aa
aa
aa
aa
"}
(2,1,1) = {"
aa
aa
aa
aa
aa
aa
aa
aa
aa
aa
aa
aa
aa
aa
aa
aa
aa
aa
aa
aa
aa
aa
aa
aa
aa
aa
aa
aa
aa
aa
aa
aa
aa
aa
aa
aa
aa
"}
(3,1,1) = {"
aa
aa
aa
aa
aa
aa
aa
aa
aa
aa
aa
aa
aa
aa
aa
aa
aa
aa
aa
aa
aa
aa
aa
aa
aa
aa
aa
aa
aa
aa
aa
aa
aa
aa
aa
aa
aa
"}
(4,1,1) = {"
aa
aa
aa
aa
aa
aa
aa
aa
aa
aa
aa
aa
aa
aa
aa
aa
aa
aa
aa
aa
aa
aa
aa
aa
aa
aa
aa
aa
aa
aa
aa
aa
aa
aa
aa
aa
aa
"}
(5,1,1) = {"
aa
aa
aa
aa
aa
aa
aa
aa
aa
aa
aa
aa
aa
aa
aa
aa
aa
aa
aa
aa
aa
aa
aa
aa
aa
aa
aa
aa
aa
aa
aa
aa
aa
aa
aa
aa
aa
"}
(6,1,1) = {"
aa
aa
aa
aa
aa
aa
aa
aa
aa
aa
aa
aa
aa
aa
aa
aa
aa
aa
aa
aa
aa
aa
aa
aa
aa
aa
aa
aa
aa
aa
aa
aa
aa
aa
aa
aa
aa
"}
(7,1,1) = {"
aa
aa
aa
aa
aa
aa
aa
aa
aa
aa
aa
aa
aa
aa
aa
aa
aa
aa
aa
aa
aa
aa
aa
aa
aa
aa
aa
aa
aa
aa
aa
aa
aa
aa
aa
aa
aa
"}
(8,1,1) = {"
aa
aa
aa
aa
aa
aa
aa
aa
aa
aa
aa
aa
ab
aw
aJ
aR
ab
aa
aa
aa
aa
aa
aa
aa
ab
ab
ab
ab
ab
aa
aa
aa
aa
aa
aa
aa
aa
"}
(9,1,1) = {"
aa
aa
aa
aa
aa
aa
aa
aa
aa
aa
aa
aa
ab
ax
ax
ax
ab
aa
aa
aa
aa
aa
aa
aa
ab
bj
bk
bk
ab
aa
aa
aa
aa
aa
aa
aa
aa
"}
(10,1,1) = {"
aa
aa
aa
aa
aa
aa
aa
aa
aa
aa
aa
aa
ab
ay
ax
ax
ab
aa
aa
aa
aa
aa
aa
aa
ab
bk
bk
bk
ab
aa
aa
aa
aa
aa
aa
aa
aa
"}
(11,1,1) = {"
aa
aa
aa
aa
aa
aa
aa
aa
aa
aa
aa
aa
ab
az
az
az
ab
aa
aa
aa
aa
aa
aa
aa
ab
bk
bk
bk
ab
aa
aa
aa
aa
aa
aa
aa
aa
"}
(12,1,1) = {"
aa
aa
aa
aa
aa
aa
aa
aa
aa
aa
aa
aa
ab
aA
aK
aS
ab
aa
aa
aa
aa
aa
aa
aa
ab
bk
bk
bj
ab
aa
aa
aa
aa
aa
aa
aa
aa
"}
(13,1,1) = {"
aa
aa
aa
aa
aa
aa
aa
aa
aa
aa
aa
ab
ab
ab
aL
ab
ab
ab
aa
aa
aa
aa
aa
ab
ab
aw
aJ
aR
ab
ab
aa
aa
aa
aa
aa
aa
aa
"}
(14,1,1) = {"
aa
aa
aa
aa
aa
aa
aa
aa
aa
aa
ab
ab
av
ar
as
aT
ba
ab
ab
aa
aa
aa
ab
ab
bh
bg
bn
bg
bh
ab
ab
aa
aa
aa
aa
aa
aa
"}
(15,1,1) = {"
aa
aa
aa
aa
aa
ab
ab
ab
ab
ab
ab
aq
as
as
as
as
as
bc
ab
aw
aJ
aR
ab
bf
bg
bg
bg
bg
bg
br
ab
ab
ab
ab
ab
ab
aa
"}
(16,1,1) = {"
aa
aa
aa
aa
aa
ac
af
ai
al
an
ab
ar
as
aB
aM
aB
as
bd
ab
as
as
as
ab
bg
bg
ac
ab
ac
bg
bg
ac
bt
bt
bt
bv
ab
aa
"}
(17,1,1) = {"
aa
aa
aa
aa
aa
ad
ag
aj
am
am
ap
as
as
aC
aN
aU
as
as
be
as
as
as
be
bg
bg
ad
bo
ad
bg
bs
ad
bt
bt
bt
bt
ab
aa
"}
(18,1,1) = {"
aa
aa
aa
aa
aa
ae
ah
ak
am
ao
ab
at
as
aD
aO
aD
as
ar
ab
as
as
as
ab
bg
bg
ae
ab
ae
bg
bg
ae
bt
bu
bt
bt
ab
aa
"}
(19,1,1) = {"
aa
aa
aa
aa
aa
ab
ab
ab
ab
ab
ab
au
as
as
as
as
as
bc
ab
aw
aJ
aR
ab
bf
bg
bg
bg
bg
bg
br
ab
ab
ab
ab
ab
ab
aa
"}
(20,1,1) = {"
aa
aa
aa
aa
aa
aa
aa
aa
aa
aa
ab
ab
au
aE
as
aV
bb
ab
ab
aa
aa
aa
ab
ab
bi
bg
bp
bg
bi
ab
ab
aa
aa
aa
aa
aa
aa
"}
(21,1,1) = {"
aa
aa
aa
aa
aa
aa
aa
aa
aa
aa
aa
ab
ab
ab
aP
ab
ab
ab
aa
aa
aa
aa
aa
ab
ab
aw
aJ
aR
ab
ab
aa
aa
aa
aa
aa
aa
aa
"}
(22,1,1) = {"
aa
aa
aa
aa
aa
aa
aa
aa
aa
aa
aa
aa
ab
aF
aQ
aW
ab
aa
aa
aa
aa
aa
aa
aa
ab
bl
bl
bq
ab
aa
aa
aa
aa
aa
aa
aa
aa
"}
(23,1,1) = {"
aa
aa
aa
aa
aa
aa
aa
aa
aa
aa
aa
aa
ab
aG
aQ
aX
ab
aa
aa
aa
aa
aa
aa
aa
ab
bl
bl
bl
ab
aa
aa
aa
aa
aa
aa
aa
aa
"}
(24,1,1) = {"
aa
aa
aa
aa
aa
aa
aa
aa
aa
aa
aa
aa
ab
aH
aQ
aY
ab
aa
aa
aa
aa
aa
aa
aa
ab
bl
bl
bl
ab
aa
aa
aa
aa
aa
aa
aa
aa
"}
(25,1,1) = {"
aa
aa
aa
aa
aa
aa
aa
aa
aa
aa
aa
aa
ab
aI
aQ
aZ
ab
aa
aa
aa
aa
aa
aa
aa
ab
bm
bl
bl
ab
aa
aa
aa
aa
aa
aa
aa
aa
"}
(26,1,1) = {"
aa
aa
aa
aa
aa
aa
aa
aa
aa
aa
aa
aa
ab
aw
aJ
aR
ab
aa
aa
aa
aa
aa
aa
aa
ab
ab
ab
ab
ab
aa
aa
aa
aa
aa
aa
aa
aa
"}
(27,1,1) = {"
aa
aa
aa
aa
aa
aa
aa
aa
aa
aa
aa
aa
aa
aa
aa
aa
aa
aa
aa
aa
aa
aa
aa
aa
aa
aa
aa
aa
aa
aa
aa
aa
aa
aa
aa
aa
aa
"}
(28,1,1) = {"
aa
aa
aa
aa
aa
aa
aa
aa
aa
aa
aa
aa
aa
aa
aa
aa
aa
aa
aa
aa
aa
aa
aa
aa
aa
aa
aa
aa
aa
aa
aa
aa
aa
aa
aa
aa
aa
"}
(29,1,1) = {"
aa
aa
aa
aa
aa
aa
aa
aa
aa
aa
aa
aa
aa
aa
aa
aa
aa
aa
aa
aa
aa
aa
aa
aa
aa
aa
aa
aa
aa
aa
aa
aa
aa
aa
aa
aa
aa
"}
(30,1,1) = {"
aa
aa
aa
aa
aa
aa
aa
aa
aa
aa
aa
aa
aa
aa
aa
aa
aa
aa
aa
aa
aa
aa
aa
aa
aa
aa
aa
aa
aa
aa
aa
aa
aa
aa
aa
aa
aa
"}
(31,1,1) = {"
aa
aa
aa
aa
aa
aa
aa
aa
aa
aa
aa
aa
aa
aa
aa
aa
aa
aa
aa
aa
aa
aa
aa
aa
aa
aa
aa
aa
aa
aa
aa
aa
aa
aa
aa
aa
aa
"}
(32,1,1) = {"
aa
aa
aa
aa
aa
aa
aa
aa
aa
aa
aa
aa
aa
aa
aa
aa
aa
aa
aa
aa
aa
aa
aa
aa
aa
aa
aa
aa
aa
aa
aa
aa
aa
aa
aa
aa
aa
"}
(33,1,1) = {"
aa
aa
aa
aa
aa
aa
aa
aa
aa
aa
aa
aa
aa
aa
aa
aa
aa
aa
aa
aa
aa
aa
aa
aa
aa
aa
aa
aa
aa
aa
aa
aa
aa
aa
aa
aa
aa
"}
