//MAP CONVERTED BY dmm2tgm.py THIS HEADER COMMENT PREVENTS RECONVERSION, DO NOT REMOVE
"aa" = (
/turf/template_noop,
/area/template_noop)
"ab" = (
/turf/simulated/wall/r_wall/prepainted,
/area/map_template/crashed_pod)
"ac" = (
/obj/effect/wallframe_spawn/reinforced_phoron/prepainted,
/turf/simulated/floor/plating,
/area/map_template/crashed_pod)
"ad" = (
/obj/machinery/atmospherics/unary/engine{
	desc = "Simple rocket nozzle, expelling gas at hypersonic velocities to propell the ship. Looks like this one was broken due emergency landing...";
	idle_power_usage = 0;
	name = "broken rocket nozzle"
	},
/turf/simulated/floor/plating,
/area/map_template/crashed_pod)
"ae" = (
/obj/effect/wallframe_spawn/reinforced_phoron/prepainted,
/obj/effect/submap_landmark/joinable_submap/crashed_pod,
/turf/simulated/floor/plating,
/area/map_template/crashed_pod)
"af" = (
/obj/machinery/atmospherics/pipe/simple/visible/red{
	icon_state = "intact";
	dir = 6
	},
/turf/simulated/wall/r_wall/prepainted,
/area/map_template/crashed_pod)
"ag" = (
/obj/machinery/atmospherics/pipe/simple/visible/red{
	dir = 10
	},
/obj/effect/wallframe_spawn/reinforced_phoron/prepainted,
/turf/simulated/floor/plating,
/area/map_template/crashed_pod)
"ah" = (
/obj/machinery/alarm{
	dir = 4;
	locked = 0;
	pixel_x = -25;
	pixel_y = 0
	},
/obj/machinery/atmospherics/unary/vent_pump/on{
	dir = 4;
	level = 2
	},
/obj/machinery/power/port_gen/pacman/super,
/turf/simulated/floor/tiled/techfloor/grid,
/area/map_template/crashed_pod)
"ai" = (
/obj/machinery/atmospherics/pipe/simple/hidden/supply{
	dir = 10
	},
/turf/simulated/floor/tiled/techfloor,
/area/map_template/crashed_pod)
"aj" = (
/obj/item/trash/raisins,
/obj/item/weapon/reagent_containers/food/drinks/glass2/fitnessflask,
/turf/simulated/floor/tiled/techfloor,
/area/map_template/crashed_pod)
"ak" = (
/obj/machinery/power/terminal,
/obj/machinery/light/small{
	dir = 1
	},
/obj/structure/cable{
	icon_state = "0-4";
	d2 = 4
	},
/turf/simulated/floor/tiled/techfloor/grid,
/area/map_template/crashed_pod)
"al" = (
/obj/structure/sign/kiddieplaque{
	desc = "A plaque with information regarding this particular lifepod. It reads: 'Armalev Industries Skyfin-E, Exoplanetary Suvival Pod' there's a registry number, and an assigned mothership, but they've both been scratched to illegiblity.";
	name = "\improper Lifepod Plaque";
	pixel_y = 30
	},
/obj/structure/cable{
	d1 = 2;
	d2 = 8;
	icon_state = "2-8"
	},
/turf/simulated/floor/tiled/techfloor/grid,
/area/map_template/crashed_pod)
"am" = (
/obj/machinery/atmospherics/omni/filter,
/turf/simulated/floor/tiled/techfloor/grid,
/area/map_template/crashed_pod)
"an" = (
/obj/machinery/atmospherics/pipe/simple/visible/cyan{
	icon_state = "intact";
	dir = 6
	},
/turf/simulated/floor/tiled/techfloor,
/area/map_template/crashed_pod)
"ao" = (
/obj/machinery/atmospherics/pipe/manifold/visible/red{
	icon_state = "map";
	dir = 4
	},
/obj/item/trash/tastybread,
/obj/item/weapon/reagent_containers/food/drinks/cans/speer,
/turf/simulated/floor/tiled/techfloor,
/area/map_template/crashed_pod)
"ap" = (
/obj/effect/decal/cleanable/vomit,
/obj/effect/decal/cleanable/filth,
/obj/structure/curtain/open/shower/engineering,
/obj/structure/hygiene/toilet{
	dir = 8
	},
/obj/item/weapon/storage/mirror{
	pixel_x = 27
	},
/obj/item/weapon/stock_parts/circuitboard/solar_control,
/turf/simulated/floor/tiled/techfloor/grid,
/area/map_template/crashed_pod)
"aq" = (
/obj/structure/closet/hydrant{
	pixel_x = -27
	},
/obj/machinery/atmospherics/unary/vent_scrubber/on{
	dir = 4
	},
/turf/simulated/floor/tiled/techfloor/grid,
/area/map_template/crashed_pod)
"ar" = (
/obj/machinery/atmospherics/pipe/simple/hidden/supply,
/obj/machinery/atmospherics/pipe/simple/hidden/scrubbers{
	dir = 10
	},
/turf/simulated/floor/tiled/techfloor,
/area/map_template/crashed_pod)
"as" = (
/obj/effect/floor_decal/industrial/outline/blue,
/obj/machinery/power/apc{
	dir = 2;
	locked = 0;
	name = "south bump";
	operating = 1;
	pixel_y = -28
	},
/obj/structure/cable{
	icon_state = "0-4";
	d2 = 4
	},
/obj/effect/decal/cleanable/filth,
/obj/machinery/portable_atmospherics/canister/carbon_dioxide,
/turf/simulated/floor/tiled/techfloor/grid,
/area/map_template/crashed_pod)
"at" = (
/obj/effect/floor_decal/industrial/outline/blue,
/obj/structure/cable{
	d1 = 4;
	d2 = 8;
	icon_state = "4-8"
	},
/obj/machinery/space_heater,
/turf/simulated/floor/tiled/techfloor/grid,
/area/map_template/crashed_pod)
"au" = (
/obj/structure/cable{
	d2 = 8;
	icon_state = "0-8"
	},
/obj/machinery/power/smes/buildable{
	charge = 50000;
	inputting = 1;
	outputting = 1
	},
/turf/simulated/floor/tiled/techfloor/grid,
/area/map_template/crashed_pod)
"av" = (
/obj/machinery/atmospherics/omni/filter,
/turf/simulated/floor/tiled/techfloor,
/area/map_template/crashed_pod)
"aw" = (
/obj/structure/closet/crate,
/obj/effect/floor_decal/industrial/hatch/orange,
/obj/item/device/scanner/gas,
/obj/item/weapon/stock_parts/circuitboard/unary_atmos/cooler,
/obj/item/weapon/stock_parts/circuitboard/unary_atmos/heater,
/obj/item/weapon/stock_parts/circuitboard/oxyregenerator,
/obj/item/weapon/tank/oxygen/yellow,
/obj/structure/cable,
/obj/item/stack/material/uranium/ten,
/obj/item/stack/material/uranium/ten,
/obj/item/stack/material/uranium/ten,
/obj/item/stack/material/uranium/ten,
/obj/item/stack/material/uranium/ten,
/obj/item/stack/material/uranium/ten,
/obj/item/stack/material/uranium/ten,
/obj/item/stack/material/uranium/ten,
/obj/item/stack/material/uranium/ten,
/obj/item/clothing/under/savage_hunter,
/obj/item/clothing/under/savage_hunter/female,
/obj/item/clothing/under/wetsuit,
/obj/item/trash/proteinbar,
/obj/item/trash/liquidfood,
/obj/item/weapon/stock_parts/matter_bin/super,
/obj/item/weapon/stock_parts/circuitboard/biogenerator,
/obj/item/weapon/bedsheet/orange,
/obj/item/weapon/bedsheet/orange,
/obj/item/weapon/stock_parts/matter_bin/adv,
/obj/item/weapon/stock_parts/micro_laser/ultra,
/obj/item/weapon/reagent_containers/food/snacks/liquidfood,
/obj/item/stack/material/sandstone{
	amount = 50
	},
/turf/simulated/floor/tiled/techfloor/grid,
/area/map_template/crashed_pod)
"ax" = (
/turf/simulated/wall/prepainted,
/area/map_template/crashed_pod)
"ay" = (
/obj/effect/wallframe_spawn/reinforced,
/obj/machinery/door/firedoor,
/turf/simulated/floor/plating,
/area/map_template/crashed_pod)
"az" = (
/obj/machinery/atmospherics/pipe/manifold/visible/cyan{
	icon_state = "map";
	dir = 8
	},
/obj/structure/reagent_dispensers/fueltank,
/turf/simulated/floor/tiled/techfloor/grid,
/area/map_template/crashed_pod)
"aA" = (
/obj/machinery/atmospherics/pipe/manifold/visible/red{
	icon_state = "map";
	dir = 4
	},
/turf/simulated/floor/tiled/techfloor,
/area/map_template/crashed_pod)
"aB" = (
/obj/machinery/sleeper{
	dir = 4
	},
/obj/effect/floor_decal/industrial/outline/blue,
/turf/simulated/floor/tiled/techfloor/grid,
/area/map_template/crashed_pod)
"aC" = (
/obj/effect/decal/cleanable/filth,
/obj/structure/curtain/open/shower/engineering,
/obj/structure/hygiene/shower{
	dir = 8;
	icon_state = "shower";
	pixel_x = -6;
	pixel_y = 0
	},
/turf/simulated/floor/tiled/techfloor/grid,
/area/map_template/crashed_pod)
"aD" = (
/obj/machinery/door/firedoor,
/obj/machinery/door/airlock/engineering,
/obj/machinery/atmospherics/pipe/simple/hidden/supply,
/obj/machinery/atmospherics/pipe/simple/hidden/scrubbers,
/turf/simulated/floor/tiled/techfloor/grid,
/area/map_template/crashed_pod)
"aE" = (
/obj/machinery/sleeper{
	dir = 4
	},
/obj/effect/floor_decal/industrial/outline/blue,
/obj/effect/decal/cleanable/cobweb,
/turf/simulated/floor/tiled/techfloor/grid,
/area/map_template/crashed_pod)
"aF" = (
/obj/machinery/atmospherics/pipe/simple/hidden/supply{
	dir = 4
	},
/obj/machinery/atmospherics/unary/vent_scrubber/on{
	dir = 8
	},
/obj/machinery/light/small{
	dir = 1
	},
/obj/item/weapon/mop,
/obj/item/trash/proteinbar,
/obj/item/trash/liquidfood,
/obj/item/weapon/storage/box/detergent,
/obj/item/clothing/mask/plunger,
/turf/simulated/floor/tiled/techfloor,
/area/map_template/crashed_pod)
"aG" = (
/obj/machinery/atmospherics/unary/vent_pump/on{
	dir = 8
	},
/obj/machinery/portable_atmospherics/canister/oxygen,
/turf/simulated/floor/tiled/techfloor,
/area/map_template/crashed_pod)
"aH" = (
/obj/machinery/atmospherics/pipe/simple/hidden/cyan,
/obj/effect/decal/cleanable/filth,
/obj/machinery/atmospherics/portables_connector{
	dir = 4
	},
/obj/machinery/portable_atmospherics/canister/empty,
/turf/simulated/floor/tiled/techfloor,
/area/map_template/crashed_pod)
"aI" = (
/obj/machinery/atmospherics/unary/tank/air,
/obj/effect/floor_decal/industrial/outline/blue,
/obj/effect/decal/cleanable/generic,
/turf/simulated/floor/tiled/techfloor,
/area/map_template/crashed_pod)
"aJ" = (
/obj/machinery/light/small{
	dir = 1
	},
/obj/item/solar_assembly,
/obj/item/solar_assembly,
/obj/item/solar_assembly,
/obj/item/solar_assembly,
/obj/machinery/atmospherics/pipe/simple/visible/red{
	icon_state = "intact";
	dir = 4
	},
/turf/simulated/floor/tiled/techfloor,
/area/map_template/crashed_pod)
"aK" = (
/obj/machinery/door/firedoor,
/obj/machinery/door/airlock/engineering,
/obj/machinery/atmospherics/pipe/manifold/visible/red{
	icon_state = "map";
	dir = 4
	},
/turf/simulated/floor/tiled/techfloor/grid,
/area/map_template/crashed_pod)
"aL" = (
/obj/effect/floor_decal/industrial/warning{
	dir = 8
	},
/obj/machinery/atmospherics/pipe/simple/hidden/scrubbers,
/obj/machinery/atmospherics/pipe/manifold/hidden/supply{
	dir = 8
	},
/turf/simulated/floor/tiled/techfloor/grid,
/area/map_template/crashed_pod)
"aM" = (
/obj/machinery/pipedispenser,
/obj/effect/floor_decal/industrial/outline/blue,
/obj/effect/decal/cleanable/generic,
/obj/effect/decal/cleanable/cobweb2,
/turf/simulated/floor/tiled/techfloor/grid,
/area/map_template/crashed_pod)
"aN" = (
/obj/machinery/atmospherics/pipe/simple/hidden/universal{
	icon_state = "map_universal";
	dir = 4
	},
/turf/simulated/floor/tiled/techfloor,
/area/map_template/crashed_pod)
"aO" = (
/obj/machinery/atmospherics/binary/pump{
	dir = 8
	},
/turf/simulated/floor/tiled/techfloor,
/area/map_template/crashed_pod)
"aP" = (
/obj/machinery/atmospherics/pipe/manifold/hidden,
/turf/simulated/floor/tiled/techfloor,
/area/map_template/crashed_pod)
"aQ" = (
/obj/machinery/atmospherics/pipe/simple/hidden/cyan{
	dir = 9;
	icon_state = "intact"
	},
/obj/item/trash/tastybread,
/turf/simulated/floor/tiled/techfloor,
/area/map_template/crashed_pod)
"aR" = (
/obj/machinery/fabricator,
/obj/effect/floor_decal/industrial/outline/blue,
/turf/simulated/floor/tiled/techfloor/grid,
/area/map_template/crashed_pod)
"aS" = (
/obj/effect/floor_decal/industrial/warning{
	dir = 8
	},
/obj/machinery/atmospherics/pipe/manifold/hidden/scrubbers{
	dir = 8
	},
/obj/machinery/atmospherics/pipe/manifold/hidden/supply{
	dir = 8
	},
/turf/simulated/floor/tiled/techfloor/grid,
/area/map_template/crashed_pod)
"aT" = (
/turf/simulated/floor/tiled/techfloor,
/area/map_template/crashed_pod)
"aU" = (
/obj/effect/floor_decal/industrial/warning{
	dir = 4
	},
/obj/machinery/atmospherics/pipe/manifold/visible/red{
	icon_state = "map";
	dir = 4
	},
/turf/simulated/floor/tiled/techfloor/grid,
/area/map_template/crashed_pod)
"aV" = (
/obj/effect/floor_decal/industrial/warning{
	dir = 4
	},
/obj/machinery/atmospherics/pipe/simple/visible/red,
/turf/simulated/floor/tiled/techfloor/grid,
/area/map_template/crashed_pod)
"aW" = (
/obj/machinery/light/small{
	dir = 1
	},
/obj/structure/bed/chair,
/obj/structure/closet/hydrant{
	pixel_x = -27
	},
/turf/simulated/floor/tiled/techfloor/grid,
/area/map_template/crashed_pod)
"aX" = (
/obj/machinery/atmospherics/pipe/simple/hidden/supply{
	dir = 4
	},
/obj/machinery/atmospherics/pipe/simple/hidden/scrubbers{
	dir = 4
	},
/turf/simulated/floor/tiled/techfloor,
/area/map_template/crashed_pod)
"aY" = (
/obj/effect/submap_landmark/spawnpoint/crashed_pod_survivor,
/obj/structure/bed/chair/shuttle/black,
/obj/structure/window/reinforced{
	dir = 8
	},
/obj/machinery/atmospherics/pipe/simple/hidden/scrubbers,
/obj/machinery/light{
	dir = 1
	},
/turf/simulated/floor/tiled/dark/monotile,
/area/map_template/crashed_pod)
"aZ" = (
/obj/effect/submap_landmark/spawnpoint/crashed_pod_survivor,
/obj/structure/bed/chair/shuttle/black,
/turf/simulated/floor/tiled/dark/monotile,
/area/map_template/crashed_pod)
"ba" = (
/obj/structure/table/steel_reinforced,
/obj/item/device/radio,
/obj/item/device/radio,
/obj/item/device/radio,
/obj/item/device/radio,
/obj/item/device/radio,
/obj/random/plushie,
/turf/simulated/floor/tiled/dark/monotile,
/area/map_template/crashed_pod)
"bb" = (
/obj/structure/table/steel_reinforced,
/obj/machinery/recharger,
/obj/item/weapon/reagent_containers/food/drinks/glass2/coffeecup/metal,
/turf/simulated/floor/tiled/dark/monotile,
/area/map_template/crashed_pod)
"bc" = (
/obj/effect/submap_landmark/spawnpoint/crashed_pod_survivor,
/obj/structure/bed/chair/shuttle/black,
/obj/structure/window/reinforced{
	dir = 4
	},
/obj/machinery/light{
	dir = 1
	},
/turf/simulated/floor/tiled/dark/monotile,
/area/map_template/crashed_pod)
"bd" = (
/obj/structure/closet/emcloset,
/obj/machinery/light/small{
	dir = 1
	},
/obj/item/weapon/crowbar,
/obj/item/weapon/crowbar,
/turf/simulated/floor/tiled/techfloor/grid,
/area/map_template/crashed_pod)
"be" = (
/obj/structure/window/reinforced{
	dir = 8
	},
/obj/effect/floor_decal/industrial/warning,
/turf/simulated/floor/tiled/dark,
/area/map_template/crashed_pod)
"bf" = (
/obj/effect/floor_decal/industrial/warning,
/turf/simulated/floor/tiled/dark,
/area/map_template/crashed_pod)
"bg" = (
/obj/machinery/atmospherics/unary/vent_pump/on,
/obj/effect/floor_decal/industrial/warning,
/turf/simulated/floor/tiled/dark,
/area/map_template/crashed_pod)
"bh" = (
/obj/machinery/atmospherics/unary/vent_scrubber/on,
/obj/effect/floor_decal/industrial/warning,
/turf/simulated/floor/tiled/dark,
/area/map_template/crashed_pod)
"bi" = (
/obj/effect/floor_decal/industrial/warning,
/obj/item/trash/proteinbar,
/obj/item/trash/liquidfood,
/turf/simulated/floor/tiled/dark,
/area/map_template/crashed_pod)
"bj" = (
/obj/structure/window/reinforced{
	dir = 4
	},
/obj/effect/floor_decal/industrial/warning,
/turf/simulated/floor/tiled/dark,
/area/map_template/crashed_pod)
"bk" = (
/obj/machinery/door/firedoor,
/obj/machinery/door/airlock/civilian,
/obj/machinery/atmospherics/pipe/simple/hidden/scrubbers,
/obj/machinery/atmospherics/pipe/simple/hidden/supply,
/turf/simulated/floor/tiled/techfloor,
/area/map_template/crashed_pod)
"bl" = (
/obj/structure/table/steel_reinforced,
/obj/item/weapon/storage/backpack/dufflebag/eng,
/obj/item/weapon/material/ashtray/bronze,
/obj/item/weapon/paper_bin,
/obj/item/weapon/reagent_containers/food/drinks/cans/speer,
/obj/item/weapon/pen,
/turf/simulated/floor/tiled/techfloor/grid,
/area/map_template/crashed_pod)
"bm" = (
/obj/machinery/door/firedoor,
/obj/machinery/door/airlock/civilian,
/obj/machinery/atmospherics/pipe/simple/hidden/universal,
/turf/simulated/floor/tiled/techfloor,
/area/map_template/crashed_pod)
"bn" = (
/obj/machinery/atmospherics/pipe/simple/hidden/supply,
/obj/machinery/atmospherics/pipe/simple/hidden/scrubbers,
/turf/simulated/floor/tiled/techfloor,
/area/map_template/crashed_pod)
"bo" = (
/obj/machinery/atmospherics/pipe/simple/hidden/scrubbers,
/obj/effect/decal/cleanable/filth,
/turf/simulated/floor/tiled/techfloor,
/area/map_template/crashed_pod)
"bp" = (
/obj/machinery/atmospherics/pipe/simple/hidden/scrubbers,
/turf/simulated/floor/tiled/techfloor,
/area/map_template/crashed_pod)
"bq" = (
/obj/structure/table/steel_reinforced,
/obj/item/weapon/reagent_containers/food/condiment/small/saltshaker,
/obj/item/weapon/reagent_containers/food/condiment/small/peppermill,
/obj/effect/decal/cleanable/flour,
/obj/item/trash/proteinbar,
/obj/machinery/reagentgrinder,
/obj/item/weapon/reagent_containers/food/condiment/small/sugar,
/turf/simulated/floor/tiled/techfloor/grid,
/area/map_template/crashed_pod)
"br" = (
/obj/machinery/alarm{
	dir = 4;
	locked = 0;
	pixel_x = -25;
	pixel_y = 0
	},
/obj/structure/bed/chair{
	dir = 1
	},
/turf/simulated/floor/tiled/techfloor/grid,
/area/map_template/crashed_pod)
"bs" = (
/obj/machinery/atmospherics/binary/pump,
/turf/simulated/wall/prepainted,
/area/map_template/crashed_pod)
"bt" = (
/obj/machinery/atmospherics/pipe/simple/hidden/supply{
	dir = 5
	},
/obj/machinery/atmospherics/pipe/simple/hidden/scrubbers{
	dir = 5
	},
/turf/simulated/floor/tiled/techfloor,
/area/map_template/crashed_pod)
"bu" = (
/obj/structure/table/steel_reinforced,
/obj/machinery/microwave,
/turf/simulated/floor/tiled/techfloor/grid,
/area/map_template/crashed_pod)
"bv" = (
/obj/machinery/atmospherics/pipe/manifold/hidden/supply{
	dir = 4
	},
/obj/machinery/atmospherics/pipe/manifold/hidden/scrubbers{
	dir = 1
	},
/obj/effect/decal/cleanable/filth,
/turf/simulated/floor/tiled/techfloor,
/area/map_template/crashed_pod)
"bw" = (
/obj/machinery/atmospherics/pipe/manifold/hidden/scrubbers,
/turf/simulated/floor/tiled/techfloor,
/area/map_template/crashed_pod)
"bx" = (
/obj/machinery/atmospherics/pipe/simple/hidden/scrubbers{
	dir = 4
	},
/turf/simulated/floor/tiled/techfloor,
/area/map_template/crashed_pod)
"by" = (
/obj/effect/floor_decal/industrial/warning,
/obj/machinery/light/small,
/obj/effect/decal/cleanable/ash,
/obj/item/trash/cigbutt/cigarbutt,
/turf/simulated/floor/tiled/techfloor/grid,
/area/map_template/crashed_pod)
"bz" = (
/obj/machinery/atmospherics/pipe/simple/hidden/scrubbers{
	dir = 9
	},
/turf/simulated/floor/tiled/techfloor,
/area/map_template/crashed_pod)
"bA" = (
/obj/effect/floor_decal/industrial/warning,
/obj/structure/table/steel_reinforced,
/obj/item/device/binoculars,
/obj/item/trash/proteinbar,
/obj/item/weapon/reagent_containers/food/drinks/cans/speer,
/turf/simulated/floor/tiled/techfloor/grid,
/area/map_template/crashed_pod)
"bB" = (
/obj/machinery/door/firedoor,
/obj/machinery/atmospherics/pipe/simple/hidden/supply,
/obj/machinery/atmospherics/pipe/simple/hidden/scrubbers,
/obj/machinery/door/airlock/engineering,
/turf/simulated/floor/tiled/techfloor,
/area/map_template/crashed_pod)
"bC" = (
/obj/effect/floor_decal/industrial/warning,
/turf/simulated/floor/tiled/techfloor,
/area/map_template/crashed_pod)
"bD" = (
/obj/effect/floor_decal/industrial/hatch/orange,
/turf/simulated/floor/tiled/techfloor,
/area/map_template/crashed_pod)
"bE" = (
/obj/structure/table/steel_reinforced,
/obj/item/trash/tastybread,
/obj/item/device/geiger,
/obj/item/device/geiger,
/turf/simulated/floor/tiled/techfloor/grid,
/area/map_template/crashed_pod)
"bF" = (
/obj/machinery/atmospherics/pipe/simple/hidden/supply,
/obj/machinery/atmospherics/unary/vent_scrubber/on{
	dir = 1
	},
/turf/simulated/floor/tiled/techfloor,
/area/map_template/crashed_pod)
"bG" = (
/obj/machinery/atmospherics/pipe/simple/hidden/supply{
	dir = 4
	},
/obj/machinery/atmospherics/pipe/simple/hidden/scrubbers{
	dir = 4
	},
/obj/structure/closet,
/obj/random/clothing,
/obj/random/clothing,
/obj/random/clothing,
/obj/random/clothing,
/obj/random/clothing,
/obj/random/clothing,
/obj/random/clothing,
/obj/random/clothing,
/obj/random/clothing,
/obj/random/gloves,
/obj/random/gloves,
/obj/random/hat,
/obj/random/hat,
/obj/random/hat,
/obj/random/hat,
/obj/random/hat,
/obj/item/clothing/under/color/orange,
/obj/item/clothing/under/color/orange,
/obj/item/clothing/under/color/blackjumpshorts,
/obj/item/clothing/under/color/black,
/turf/simulated/floor/tiled/techfloor/grid,
/area/map_template/crashed_pod)
"bH" = (
/obj/structure/reagent_dispensers/watertank,
/turf/simulated/floor/tiled/techfloor/grid,
/area/map_template/crashed_pod)
"bI" = (
/obj/structure/closet/crate,
/obj/item/weapon/storage/briefcase/inflatable,
/obj/item/weapon/storage/briefcase/inflatable,
/obj/item/weapon/storage/briefcase/inflatable,
/obj/item/weapon/storage/briefcase/inflatable,
/obj/item/weapon/storage/briefcase/inflatable,
/obj/machinery/atmospherics/pipe/simple/hidden/supply,
/obj/machinery/atmospherics/unary/vent_scrubber/on{
	dir = 1
	},
/turf/simulated/floor/tiled/techfloor,
/area/map_template/crashed_pod)
"bJ" = (
/obj/machinery/door/airlock/external{
	name = "escape pod airlock"
	},
/turf/simulated/floor/tiled/techfloor,
/area/map_template/crashed_pod)
"bK" = (
/obj/machinery/atmospherics/pipe/simple/hidden/supply{
	dir = 4
	},
/obj/machinery/atmospherics/pipe/simple/hidden/scrubbers{
	dir = 4
	},
/obj/structure/closet,
/obj/random/clothing,
/obj/random/clothing,
/obj/random/clothing,
/obj/random/clothing,
/obj/random/clothing,
/obj/random/clothing,
/obj/random/clothing,
/obj/random/clothing,
/obj/random/gloves,
/obj/random/gloves,
/obj/random/hat,
/obj/random/hat,
/obj/random/hat,
/obj/random/hat,
/obj/random/hat,
/obj/item/clothing/under/color/orange,
/obj/item/clothing/under/color/orange,
/obj/item/clothing/under/color/blackjumpshorts,
/obj/item/clothing/under/color/black,
/turf/simulated/floor/tiled/techfloor/grid,
/area/map_template/crashed_pod)
"bL" = (
/obj/machinery/atmospherics/pipe/simple/hidden/supply{
	dir = 4
	},
/obj/machinery/atmospherics/pipe/simple/hidden/scrubbers{
	dir = 4
	},
/obj/structure/closet,
/obj/random/clothing,
/obj/random/clothing,
/obj/random/clothing,
/obj/random/clothing,
/obj/random/clothing,
/obj/random/clothing,
/obj/random/clothing,
/obj/random/clothing,
/obj/random/gloves,
/obj/random/hat,
/obj/random/hat,
/obj/random/hat,
/obj/item/clothing/under/color/orange,
/obj/item/clothing/under/color/orange,
/obj/item/clothing/under/color/blackjumpshorts,
/obj/item/clothing/under/color/black,
/turf/simulated/floor/tiled/techfloor/grid,
/area/map_template/crashed_pod)
"bM" = (
/obj/structure/closet/emcloset,
/obj/machinery/light/small,
/obj/item/weapon/crowbar,
/obj/item/weapon/crowbar,
/turf/simulated/floor/tiled/techfloor/grid,
/area/map_template/crashed_pod)
"bN" = (
/obj/machinery/seed_extractor,
/turf/simulated/floor/tiled/techfloor/grid,
/area/map_template/crashed_pod)
"bO" = (
/obj/machinery/atmospherics/pipe/manifold/hidden/supply{
	dir = 8
	},
/obj/machinery/atmospherics/pipe/manifold/hidden/scrubbers{
	dir = 8
	},
/turf/simulated/floor/tiled/techfloor,
/area/map_template/crashed_pod)
"bP" = (
/obj/machinery/portable_atmospherics/hydroponics,
/turf/simulated/floor/tiled/techfloor/grid,
/area/map_template/crashed_pod)
"bQ" = (
/obj/machinery/atmospherics/pipe/simple/hidden/supply{
	dir = 10
	},
/obj/machinery/atmospherics/pipe/simple/hidden/scrubbers{
	dir = 10
	},
/turf/simulated/floor/tiled/techfloor,
/area/map_template/crashed_pod)
"bR" = (
/obj/machinery/atmospherics/unary/vent_pump/on{
	dir = 1
	},
/obj/machinery/light/small,
/turf/simulated/floor/tiled/techfloor,
/area/map_template/crashed_pod)
"bS" = (
/obj/effect/floor_decal/industrial/hatch/orange,
/obj/structure/table/rack,
/obj/item/clothing/suit/space/emergency,
/obj/item/clothing/head/helmet/space/emergency,
/obj/item/clothing/head/helmet/space/emergency,
/obj/item/clothing/suit/space/emergency,
/obj/item/weapon/tank/emergency/oxygen/double,
/obj/item/weapon/tank/emergency/oxygen/double,
/turf/simulated/floor/tiled/techfloor/grid,
/area/map_template/crashed_pod)
"bT" = (
/obj/structure/closet/crate,
/obj/random/handgun,
/obj/random/handgun,
/obj/random/handgun,
/obj/item/weapon/pickaxe,
/obj/item/weapon/pickaxe,
/obj/item/weapon/pickaxe,
/obj/item/stack/material/glass/fifty,
/obj/item/device/flashlight/lantern,
/obj/item/device/flashlight/lantern,
/obj/item/weapon/storage/box/glowsticks,
/obj/item/weapon/storage/box/glowsticks,
/obj/item/weapon/storage/box/glowsticks,
/obj/item/stack/material/steel/fifty,
/obj/random/toolbox,
/obj/random/toolbox,
/obj/random/toolbox,
/obj/random/toolbox,
/obj/item/stack/material/aluminium/fifty,
/obj/item/stack/material/plastic/fifty,
/obj/item/stack/material/plasteel/ten,
/obj/item/stack/material/steel/fifty,
/turf/simulated/floor/tiled/techfloor/grid,
/area/map_template/crashed_pod)
"bU" = (
/obj/machinery/atmospherics/pipe/simple/visible/red{
	icon_state = "intact";
	dir = 5
	},
/turf/simulated/wall/prepainted,
/area/map_template/crashed_pod)
"bV" = (
/obj/effect/floor_decal/industrial/hatch/orange,
/obj/structure/table/rack,
/obj/item/clothing/suit/space/emergency,
/obj/item/clothing/suit/space/emergency,
/obj/item/clothing/head/helmet/space/emergency,
/obj/item/clothing/head/helmet/space/emergency,
/obj/item/weapon/tank/emergency/oxygen/double,
/obj/item/weapon/tank/emergency/oxygen/double,
/obj/machinery/light/small{
	dir = 8
	},
/turf/simulated/floor/tiled/techfloor/grid,
/area/map_template/crashed_pod)
"bW" = (
/obj/structure/closet/crate/medical,
/obj/random/firstaid,
/obj/random/firstaid,
/obj/random/firstaid,
/obj/random/firstaid,
/obj/random/firstaid,
/obj/item/weapon/storage/firstaid/surgery,
/obj/item/weapon/storage/firstaid/stab,
/obj/item/weapon/storage/pill_bottle/antidexafen,
/obj/item/weapon/storage/pill_bottle/antidexafen,
/obj/item/weapon/storage/med_pouch/radiation,
/obj/item/weapon/storage/med_pouch/radiation,
/obj/item/weapon/storage/med_pouch/radiation,
/obj/item/weapon/storage/med_pouch/radiation,
/obj/item/weapon/storage/pill_bottle/assorted,
/turf/simulated/floor/tiled/techfloor/grid,
/area/map_template/crashed_pod)
"bX" = (
/obj/machinery/door/firedoor,
/obj/effect/wallframe_spawn/reinforced_phoron/prepainted,
/turf/simulated/floor/plating,
/area/map_template/crashed_pod)
"bY" = (
/obj/structure/closet/crate/freezer/rations,
/obj/item/weapon/storage/bag/trash,
/obj/item/weapon/storage/bag/trash,
/obj/item/weapon/storage/box/donkpockets,
/obj/item/weapon/storage/box/donkpockets,
/obj/item/weapon/storage/fancy/egg_box,
/obj/item/weapon/storage/fancy/egg_box,
/obj/item/weapon/storage/fancy/egg_box,
/obj/item/weapon/reagent_containers/food/condiment/enzyme,
/obj/item/weapon/reagent_containers/food/drinks/milk,
/obj/item/weapon/reagent_containers/food/drinks/milk,
/obj/item/trash/liquidfood,
/obj/item/trash/liquidfood,
/obj/item/trash/liquidfood,
/obj/item/trash/liquidfood,
/obj/item/weapon/beartrap,
/obj/item/weapon/material/knife/kitchen/cleaver,
/obj/item/weapon/reagent_containers/food/snacks/liquidfood,
/obj/item/weapon/reagent_containers/food/snacks/liquidfood,
/obj/item/weapon/reagent_containers/food/snacks/liquidfood,
/obj/item/weapon/reagent_containers/food/snacks/liquidfood,
/obj/item/weapon/reagent_containers/food/snacks/liquidfood,
/obj/item/weapon/reagent_containers/food/snacks/liquidfood,
/obj/item/weapon/reagent_containers/food/snacks/liquidfood,
/obj/item/weapon/reagent_containers/food/snacks/liquidfood,
/turf/simulated/floor/tiled/techfloor/grid,
/area/map_template/crashed_pod)
"cb" = (
/obj/item/device/oxycandle,
/obj/item/device/oxycandle,
/obj/item/device/oxycandle,
/obj/item/device/oxycandle,
/obj/item/device/oxycandle,
/obj/item/device/oxycandle,
/obj/item/device/oxycandle,
/obj/item/device/oxycandle,
/obj/item/device/oxycandle,
/obj/item/device/oxycandle,
/obj/item/device/oxycandle,
/obj/item/device/oxycandle,
/obj/item/device/oxycandle,
/obj/item/device/oxycandle,
/obj/item/device/oxycandle,
/obj/item/device/oxycandle,
/obj/item/device/oxycandle,
/obj/item/device/oxycandle,
/obj/structure/closet/crate,
/obj/machinery/atmospherics/unary/vent_pump/on{
	dir = 1
	},
/obj/machinery/light/small,
/turf/simulated/floor/tiled/techfloor,
/area/map_template/crashed_pod)
"cc" = (
/obj/structure/table/steel_reinforced,
/obj/item/device/multitool,
/obj/item/weapon/screwdriver,
/obj/item/weapon/cell/device/high,
/obj/item/weapon/cell/device/high,
/obj/item/weapon/cell/crap,
/obj/item/weapon/storage/box/lights,
/obj/item/device/scanner/gas,
/obj/item/weapon/reagent_containers/food/drinks/cans/speer,
/obj/item/weapon/reagent_containers/food/drinks/cans/speer,
/obj/item/weapon/reagent_containers/food/drinks/cans/speer,
/obj/item/weapon/storage/box/monkeycubes,
/obj/item/weapon/reagent_containers/food/drinks/bottle/vodka,
/obj/item/weapon/reagent_containers/food/drinks/bottle/specialwhiskey,
/obj/item/weapon/tracker_electronics,
/obj/item/weapon/pen/blue,
/obj/item/weapon/pen/green,
/obj/item/weapon/pen/red,
/turf/simulated/floor/tiled/techfloor/grid,
/area/map_template/crashed_pod)
"cd" = (
/obj/structure/closet/crate/large/hydroponics,
/obj/item/seeds/potatoseed,
/obj/item/seeds/potatoseed,
/obj/item/seeds/wheatseed,
/obj/item/seeds/wheatseed,
/obj/item/seeds/orangeseed,
/obj/item/seeds/orangeseed,
/obj/item/seeds/cornseed,
/obj/item/seeds/cornseed,
/obj/item/weapon/material/hatchet,
/obj/item/weapon/reagent_containers/glass/bucket,
/obj/item/weapon/material/minihoe,
/obj/item/weapon/plantspray/pests,
/obj/item/weapon/plantspray/pests,
/obj/item/weapon/plantspray/weeds,
/obj/item/seeds/poppyseed,
/obj/item/seeds/towermycelium,
/obj/item/seeds/glowshroom,
/obj/item/seeds/whitebeetseed,
/obj/item/weapon/storage/plants,
/obj/item/seeds/bananaseed,
/turf/simulated/floor/tiled/techfloor/grid,
/area/map_template/crashed_pod)

(1,1,1) = {"
aa
ab
ab
ab
ab
ab
ab
ab
ab
bX
ab
ab
ab
ab
ab
ab
"}
(2,1,1) = {"
ab
ab
ah
aq
ab
aE
aB
ax
aW
bl
br
by
ay
bV
bS
ab
"}
(3,1,1) = {"
ad
ac
ai
ar
aD
aS
aL
bk
bn
bn
bt
bC
bJ
bD
bD
bJ
"}
(4,1,1) = {"
ab
ab
aj
as
ax
aF
aN
ax
aY
be
aX
bA
ab
ab
ab
ab
"}
(5,1,1) = {"
ad
ae
aT
at
ax
aG
aO
ax
aZ
bf
aX
bE
ax
bY
bT
ab
"}
(6,1,1) = {"
ab
ab
ak
au
ay
aI
aP
ay
ba
bg
bv
bO
bB
bF
bR
bX
"}
(7,1,1) = {"
ab
ab
al
aw
ay
aI
aP
ay
bb
bh
bw
bG
ax
bW
cc
ab
"}
(8,1,1) = {"
ad
ac
an
az
bs
aH
aQ
ax
aZ
bi
bx
bK
ax
ax
ax
ab
"}
(9,1,1) = {"
ab
af
av
am
bU
aJ
aT
ax
bc
bj
bx
bL
ax
bH
bN
ab
"}
(10,1,1) = {"
ad
ag
ao
aA
aK
aU
aV
bm
bo
bp
bz
bQ
bB
bI
cb
bX
"}
(11,1,1) = {"
ab
ab
ap
aC
ax
aM
aR
ax
bd
bq
bu
bM
ax
bP
cd
ab
"}
(12,1,1) = {"
aa
ab
ab
ab
ab
ab
ab
ab
ab
bX
ab
ab
ab
ab
ab
ab
"}
