"aa" = (/turf/template_noop,/area/template_noop)
"ab" = (/obj/random/junk,/turf/template_noop,/area/template_noop)
"ac" = (/turf/simulated/wall/r_wall,/area/space)
"ad" = (/obj/random/obstruction,/turf/template_noop,/area/template_noop)
"ae" = (/turf/simulated/wall,/area/space)
"af" = (/obj/effect/floor_decal/industrial/warning{icon_state = "warning"; dir = 9},/obj/effect/decal/cleanable/dirt,/obj/machinery/light/spot{dir = 8},/turf/simulated/floor/tiled/airless,/area/space)
"ag" = (/obj/effect/floor_decal/industrial/warning{icon_state = "warning"; dir = 1},/turf/simulated/floor/tiled/airless,/area/template_noop)
"ah" = (/obj/effect/floor_decal/industrial/warning{icon_state = "warning"; dir = 1},/obj/effect/decal/cleanable/dirt,/turf/simulated/floor/tiled/airless,/area/template_noop)
"ai" = (/obj/effect/floor_decal/industrial/warning{icon_state = "warning"; dir = 5},/turf/simulated/floor/tiled/airless,/area/template_noop)
"aj" = (/obj/random/junk,/obj/random/junk,/turf/template_noop,/area/template_noop)
"ak" = (/obj/random/junk,/obj/random/junk,/obj/random/action_figure,/turf/template_noop,/area/template_noop)
"al" = (/obj/effect/wingrille_spawn/reinforced,/turf/template_noop,/area/template_noop)
"am" = (/obj/effect/floor_decal/industrial/warning{dir = 8},/obj/random/junk,/turf/simulated/floor/tiled/airless,/area/template_noop)
"an" = (/turf/simulated/floor/tiled/airless,/area/template_noop)
"ao" = (/obj/effect/decal/cleanable/dirt,/turf/simulated/floor/tiled/airless,/area/template_noop)
"ap" = (/obj/effect/floor_decal/industrial/warning{dir = 4},/obj/random/junk,/turf/simulated/floor/tiled/airless,/area/template_noop)
"aq" = (/turf/simulated/floor,/area/space)
"ar" = (/obj/machinery/atmospherics/pipe/simple/heat_exchanging{tag = "icon-intact (WEST)"; icon_state = "intact"; dir = 8},/turf/simulated/wall/r_wall,/area/space)
"as" = (/obj/machinery/atmospherics/pipe/simple/heat_exchanging{tag = "icon-intact (WEST)"; icon_state = "intact"; dir = 8},/obj/effect/mist,/turf/simulated/floor/exoplanet/water/shallow,/area/template_noop)
"at" = (/obj/machinery/atmospherics/pipe/simple/heat_exchanging{icon_state = "intact"; dir = 10},/turf/simulated/floor/exoplanet/water/shallow,/area/template_noop)
"au" = (/obj/effect/floor_decal/industrial/warning{dir = 8},/turf/simulated/floor/tiled/airless,/area/template_noop)
"av" = (/obj/effect/floor_decal/industrial/warning{dir = 4},/turf/simulated/floor/tiled/airless,/area/template_noop)
"aw" = (/turf/simulated/floor/exoplanet/water/shallow,/area/template_noop)
"ax" = (/obj/machinery/atmospherics/pipe/simple/heat_exchanging,/obj/effect/mist,/turf/simulated/floor/exoplanet/water/shallow,/area/template_noop)
"ay" = (/obj/effect/floor_decal/industrial/warning{dir = 8},/obj/effect/decal/cleanable/dirt,/turf/simulated/floor/tiled/airless,/area/template_noop)
"az" = (/obj/effect/floor_decal/industrial/warning{dir = 4},/obj/effect/decal/cleanable/dirt,/turf/simulated/floor/tiled/airless,/area/template_noop)
"aA" = (/obj/machinery/recharge_station,/turf/simulated/floor/tiled/white,/area/space)
"aB" = (/obj/machinery/power/apc{dir = 1; name = "north bump"; pixel_x = 0; pixel_y = 24},/turf/simulated/floor/tiled/white,/area/space)
"aC" = (/turf/simulated/floor/tiled/white,/area/space)
"aD" = (/obj/structure{icon = 'icons/obj/stationobjs.dmi'; icon_state = "blackbox"; name = "Blackbox"},/obj/machinery/light{dir = 8; icon_state = "tube1"; pixel_y = 0},/turf/simulated/floor/tiled/dark,/area/space)
"aE" = (/obj/machinery/computer{icon_screen = "mining"; name = "Planetery Activity Scanning Console"},/turf/simulated/floor/tiled/dark,/area/space)
"aF" = (/obj/machinery/computer/navigation{name = "orbital monitoring console"},/turf/simulated/floor/tiled/dark,/area/space)
"aG" = (/obj/machinery/telecomms/relay,/turf/simulated/floor/tiled/dark,/area/space)
"aH" = (/obj/machinery/power/apc{dir = 1; name = "north bump"; pixel_x = 0; pixel_y = 24},/turf/simulated/floor/tiled/dark,/area/space)
"aI" = (/obj/structure/closet/secure_closet/guncabinet,/obj/item/clothing/suit/armor/pcarrier/light,/obj/item/clothing/suit/armor/pcarrier/light,/obj/item/clothing/suit/armor/pcarrier/light,/obj/item/clothing/suit/armor/pcarrier/light,/obj/item/clothing/head/helmet,/obj/item/clothing/head/helmet,/obj/item/clothing/head/helmet,/obj/item/clothing/head/helmet,/turf/simulated/floor/tiled/dark,/area/space)
"aJ" = (/obj/machinery/atmospherics/pipe/simple/heat_exchanging,/turf/simulated/floor/exoplanet/water/shallow,/area/template_noop)
"aK" = (/obj/structure/table/steel,/obj/item/weapon/folder,/turf/simulated/floor/tiled/dark,/area/space)
"aL" = (/obj/structure/bed/chair/office/dark{icon_state = "officechair_dark"; dir = 8},/turf/simulated/floor/tiled/dark,/area/space)
"aM" = (/turf/simulated/floor/tiled/dark,/area/space)
"aN" = (/obj/machinery/door/airlock/glass_command{name = "Communication Center"},/turf/simulated/floor/tiled/dark,/area/space)
"aO" = (/obj/machinery/light{dir = 1},/turf/simulated/floor/tiled/dark,/area/space)
"aP" = (/obj/machinery/door/airlock/glass_security{name = "Armory"},/turf/simulated/floor/tiled/dark,/area/space)
"aQ" = (/obj/machinery/light{icon_state = "tube1"; dir = 4},/obj/structure/closet/secure_closet/guncabinet/sidearm/SMG,/turf/simulated/floor/tiled/dark,/area/space)
"aR" = (/obj/effect/decal/cleanable/dirt,/obj/effect/shuttle_landmark/automatic,/turf/simulated/floor/tiled/airless,/area/template_noop)
"aS" = (/obj/structure/toilet{pixel_y = 12},/obj/machinery/light/small{dir = 8},/turf/simulated/floor/tiled/freezer,/area/space)
"aT" = (/obj/structure/table/steel,/obj/item/weapon/paper_bin,/obj/structure/filingcabinet/wallcabinet{dir = 4; icon_state = "wallcabinet"; pixel_x = -29; tag = "icon-wallcabinet (EAST)"},/obj/item/weapon/pen,/turf/simulated/floor/tiled/dark,/area/space)
"aU" = (/obj/machinery/computer{icon_screen = "comm"; name = "Communication Console"},/turf/simulated/floor/tiled/dark,/area/space)
"aV" = (/obj/structure/table/steel,/turf/simulated/floor/tiled/dark,/area/space)
"aW" = (/obj/machinery/recharger,/obj/structure/table/steel,/obj/machinery/light{icon_state = "tube1"; dir = 4},/obj/machinery/power/apc{dir = 2; name = "south bump"; operating = 1; pixel_y = -24},/turf/simulated/floor/tiled/dark,/area/space)
"aX" = (/obj/effect/mist,/turf/simulated/floor/exoplanet/water/shallow,/area/template_noop)
"aY" = (/turf/simulated/floor/tiled/freezer,/area/space)
"aZ" = (/obj/effect/floor_decal/industrial/hatch/yellow,/obj/effect/floor_decal/industrial/warning/half,/obj/machinery/door/firedoor,/turf/simulated/floor/tiled/white,/area/space)
"ba" = (/obj/machinery/door/firedoor,/obj/effect/wingrille_spawn/reinforced,/turf/simulated/floor,/area/space)
"bb" = (/obj/effect/floor_decal/industrial/hatch/yellow,/obj/effect/floor_decal/industrial/warning/half,/obj/machinery/door/firedoor,/obj/machinery/door/airlock/glass_command{name = "Communication Center"},/turf/simulated/floor/tiled/dark,/area/space)
"bc" = (/obj/effect/floor_decal/industrial/hatch/yellow,/obj/structure/table/steel_reinforced,/turf/simulated/floor/tiled/dark,/area/space)
"bd" = (/obj/machinery/atmospherics/pipe/simple/heat_exchanging{tag = "icon-intact (SOUTHEAST)"; icon_state = "intact"; dir = 6},/turf/simulated/floor/exoplanet/water/shallow,/area/template_noop)
"be" = (/obj/machinery/atmospherics/pipe/simple/heat_exchanging{icon_state = "intact"; dir = 9},/turf/simulated/floor/exoplanet/water/shallow,/area/template_noop)
"bf" = (/obj/machinery/door/firedoor,/obj/machinery/door/airlock/maintenance,/turf/simulated/floor,/area/space)
"bg" = (/obj/effect/floor_decal/corner/grey_alt,/turf/simulated/floor/tiled,/area/space)
"bh" = (/obj/machinery/power/apc{dir = 1; name = "north bump"; pixel_x = 0; pixel_y = 24},/obj/effect/floor_decal/corner/grey_alt,/turf/simulated/floor/tiled,/area/space)
"bi" = (/obj/machinery/light{dir = 1},/obj/effect/floor_decal/corner/grey_alt,/turf/simulated/floor/tiled,/area/space)
"bj" = (/turf/simulated/floor/tiled,/area/space)
"bk" = (/obj/machinery/atmospherics/pipe/simple/heat_exchanging{tag = "icon-intact (NORTH)"; icon_state = "intact"; dir = 1},/turf/simulated/wall/r_wall,/area/space)
"bl" = (/obj/structure/sign/warning/docking_area{pixel_x = -32},/obj/effect/floor_decal/industrial/warning{dir = 8},/turf/simulated/floor/tiled/airless,/area/template_noop)
"bm" = (/obj/structure/sink{dir = 8; icon_state = "sink"; pixel_x = -14; pixel_y = 4; tag = "icon-sink (WEST)"},/obj/item/weapon/storage/mirror{pixel_x = -26},/turf/simulated/floor/tiled/freezer,/area/space)
"bn" = (/obj/machinery/light/small,/obj/machinery/power/apc{dir = 4; name = "east bump"; pixel_x = 24},/turf/simulated/floor/tiled/freezer,/area/space)
"bo" = (/obj/machinery/light,/obj/effect/floor_decal/corner/grey_alt{tag = "icon-corner_white (NORTH)"; icon_state = "corner_white"; dir = 1},/turf/simulated/floor/tiled,/area/space)
"bp" = (/obj/effect/floor_decal/corner/grey_alt{tag = "icon-corner_white (NORTH)"; icon_state = "corner_white"; dir = 1},/turf/simulated/floor/tiled,/area/space)
"bq" = (/obj/structure/closet/firecloset,/obj/effect/floor_decal/corner/grey_alt{tag = "icon-corner_white (NORTH)"; icon_state = "corner_white"; dir = 1},/turf/simulated/floor/tiled,/area/space)
"br" = (/obj/effect/decal/cleanable/dirt,/obj/effect/decal/cleanable/dirt,/turf/simulated/floor/tiled/airless,/area/template_noop)
"bs" = (/obj/effect/floor_decal/industrial/hatch/yellow,/obj/effect/floor_decal/industrial/warning/half,/obj/machinery/door/firedoor,/obj/machinery/door/airlock/glass,/turf/simulated/floor/tiled,/area/space)
"bt" = (/obj/effect/floor_decal/industrial/warning{dir = 10},/obj/machinery/light/spot{dir = 8},/turf/simulated/floor/tiled/airless,/area/space)
"bu" = (/obj/effect/floor_decal/industrial/warning,/obj/effect/decal/cleanable/dirt,/turf/simulated/floor/tiled/airless,/area/template_noop)
"bv" = (/obj/effect/floor_decal/industrial/warning,/turf/simulated/floor/tiled/airless,/area/template_noop)
"bw" = (/obj/effect/floor_decal/industrial/warning{dir = 6},/obj/effect/decal/cleanable/dirt,/turf/simulated/floor/tiled/airless,/area/template_noop)
"bx" = (/obj/machinery/light/small{dir = 8},/turf/simulated/floor/tiled/freezer,/area/space)
"by" = (/obj/machinery/shower{dir = 8; icon_state = "shower"; pixel_w = -6; tag = "icon-shower (WEST)"},/obj/structure/curtain/open/shower,/obj/machinery/door/window/westright,/obj/structure/window/reinforced,/turf/simulated/floor/tiled/freezer,/area/space)
"bz" = (/obj/structure/closet/secure_closet/freezer/fridge,/turf/simulated/floor/tiled,/area/space)
"bA" = (/obj/item/weapon/stool,/turf/simulated/floor/tiled,/area/space)
"bB" = (/obj/structure/table/standard,/obj/machinery/recharger,/turf/simulated/floor/tiled,/area/space)
"bC" = (/obj/structure/table/standard,/turf/simulated/floor/tiled,/area/space)
"bD" = (/obj/structure/table/standard,/turf/simulated/floor/tiled/white,/area/space)
"bE" = (/obj/machinery/sleeper,/turf/simulated/floor/tiled/white,/area/space)
"bF" = (/obj/structure/closet/secure_closet/medical1_minimal,/turf/simulated/floor/tiled/white,/area/space)
"bG" = (/obj/effect/decal/cleanable/dirt,/turf/simulated/floor,/area/template_noop)
"bH" = (/obj/structure/curtain/open/shower,/obj/machinery/door/window/westleft,/obj/machinery/shower{dir = 8; icon_state = "shower"; pixel_w = -6; tag = "icon-shower (WEST)"},/turf/simulated/floor/tiled/freezer,/area/space)
"bI" = (/obj/item/weapon/stool,/obj/structure/sign/warning/nosmoking_2{pixel_x = 32},/obj/structure/sink{dir = 4; icon_state = "sink"; pixel_x = 14; pixel_y = 4; tag = "icon-sink (EAST)"},/turf/simulated/floor/tiled/white,/area/space)
"bJ" = (/obj/structure/table/standard,/obj/item/weapon/storage/firstaid/surgery,/turf/simulated/floor/tiled/white,/area/space)
"bK" = (/obj/structure/grille,/turf/template_noop,/area/template_noop)
"bL" = (/turf/simulated/floor,/area/template_noop)
"bM" = (/obj/machinery/power/apc{dir = 8; name = "west bump"; pixel_x = -24},/turf/simulated/floor/tiled,/area/space)
"bN" = (/obj/machinery/door/firedoor,/obj/effect/floor_decal/industrial/hatch/yellow,/obj/effect/floor_decal/industrial/warning/half{icon_state = "warninghalf"; dir = 4},/obj/machinery/door/airlock/glass_medical{name = "Medical Section"},/turf/simulated/floor/tiled/white,/area/space)
"bO" = (/obj/structure/curtain/medical,/turf/simulated/floor/tiled/white,/area/space)
"bP" = (/obj/structure/iv_drip,/turf/simulated/floor/tiled/white,/area/space)
"bQ" = (/obj/effect/floor_decal/solarpanel,/obj/machinery/power/solar,/obj/structure/cable/green{d2 = 4; icon_state = "0-4"},/turf/simulated/floor,/area/template_noop)
"bR" = (/obj/structure/catwalk,/obj/structure/cable/green{d1 = 2; d2 = 8; icon_state = "2-8"},/obj/structure/cable/green{d1 = 2; d2 = 4; icon_state = "2-4"},/turf/simulated/floor,/area/template_noop)
"bS" = (/obj/effect/floor_decal/solarpanel,/obj/machinery/power/solar,/obj/structure/cable/green{d2 = 8; icon_state = "0-8"},/turf/simulated/floor,/area/template_noop)
"bT" = (/obj/machinery/light/small{dir = 1},/turf/simulated/floor/tiled/freezer,/area/space)
"bU" = (/obj/machinery/door/firedoor,/obj/machinery/door/airlock/freezer{name = "Freezer"},/turf/simulated/floor/tiled/freezer,/area/space)
"bV" = (/obj/effect/floor_decal/industrial/hatch/yellow,/obj/effect/floor_decal/industrial/warning/half{icon_state = "warninghalf"; dir = 4},/obj/machinery/door/firedoor,/obj/machinery/door/airlock/glass{name = "Canteen"},/turf/simulated/floor/tiled,/area/space)
"bW" = (/obj/structure/table/standard,/obj/item/weapon/paper_bin,/obj/item/weapon/folder/white,/obj/item/weapon/pen,/obj/machinery/power/apc{dir = 2; name = "south bump"; operating = 1; pixel_y = -24},/turf/simulated/floor/tiled/white,/area/space)
"bX" = (/obj/machinery/optable,/turf/simulated/floor/tiled/white,/area/space)
"bY" = (/obj/machinery/computer/operating,/turf/simulated/floor/tiled/white,/area/space)
"bZ" = (/obj/structure/catwalk,/obj/structure/cable/green{d1 = 2; d2 = 8; icon_state = "2-8"},/obj/structure/cable/green{d1 = 2; d2 = 4; icon_state = "2-4"},/obj/structure/cable/green{d1 = 1; d2 = 2; icon_state = "1-2"},/turf/simulated/floor,/area/template_noop)
"ca" = (/obj/structure/closet/secure_closet/freezer/fridge,/turf/simulated/floor/tiled/freezer,/area/space)
"cb" = (/obj/structure/sign/warning/nosmoking_1{pixel_y = -32},/turf/simulated/floor/tiled/freezer,/area/space)
"cc" = (/obj/structure/closet/crate/freezer/rations,/turf/simulated/floor/tiled/freezer,/area/space)
"cd" = (/obj/item/weapon/board,/obj/structure/table/standard,/obj/item/weapon/storage/box/checkers,/obj/item/weapon/storage/box/checkers/chess,/obj/item/weapon/storage/box/checkers/chess/red,/turf/simulated/floor/tiled,/area/space)
"ce" = (/obj/structure/table/standard,/obj/item/weapon/deck/cards,/turf/simulated/floor/tiled,/area/space)
"cf" = (/obj/machinery/light{dir = 8; icon_state = "tube1"; pixel_y = 0},/obj/effect/floor_decal/corner/grey_alt,/turf/simulated/floor/tiled,/area/space)
"cg" = (/obj/machinery/computer/operating,/turf/simulated/wall,/area/space)
"ch" = (/obj/machinery/door/airlock/maintenance,/obj/machinery/door/firedoor,/turf/simulated/floor,/area/space)
"ci" = (/obj/machinery/portable_atmospherics/canister/oxygen,/turf/simulated/floor/tiled,/area/space)
"cj" = (/obj/structure/largecrate/animal/goat,/obj/effect/floor_decal/industrial/outline/yellow,/turf/simulated/floor/tiled,/area/space)
"ck" = (/obj/effect/floor_decal/industrial/hatch/yellow,/turf/simulated/floor/tiled,/area/space)
"cl" = (/obj/machinery/power/apc{dir = 1; name = "north bump"; pixel_x = 0; pixel_y = 24},/obj/effect/floor_decal/industrial/outline/yellow,/turf/simulated/floor/tiled,/area/space)
"cm" = (/obj/structure/largecrate/hoverpod,/obj/effect/floor_decal/industrial/outline/yellow,/turf/simulated/floor/tiled,/area/space)
"cn" = (/obj/structure/catwalk,/obj/structure/cable/green{d1 = 1; d2 = 2; icon_state = "1-2"},/turf/simulated/floor,/area/template_noop)
"co" = (/obj/effect/floor_decal/industrial/outline/yellow,/turf/simulated/floor/tiled,/area/space)
"cp" = (/obj/machinery/suit_storage_unit/engineering/salvage,/obj/effect/floor_decal/industrial/outline/yellow,/turf/simulated/floor/tiled,/area/space)
"cq" = (/obj/machinery/door/firedoor,/obj/machinery/door/airlock/mining{name = "Storage"},/turf/simulated/floor/tiled,/area/space)
"cr" = (/obj/item/stack/material/steel/fifty,/obj/item/stack/material/steel/fifty,/obj/item/stack/material/glass/fifty,/obj/structure/table/rack,/obj/effect/floor_decal/industrial/outline/yellow,/turf/simulated/floor/tiled,/area/space)
"cs" = (/obj/item/weapon/storage/toolbox/mechanical,/obj/item/weapon/storage/toolbox/electrical,/obj/structure/table/rack,/obj/effect/floor_decal/industrial/outline/yellow,/obj/effect/floor_decal/industrial/warning{dir = 4},/turf/simulated/floor/tiled,/area/space)
"ct" = (/obj/structure/cable/green{d2 = 2; icon_state = "0-2"},/obj/machinery/power/port_gen/pacman/super/potato,/obj/machinery/light/small/red{tag = "icon-bulb1 (EAST)"; icon_state = "bulb1"; dir = 4},/turf/simulated/floor/reinforced,/area/space)
"cu" = (/obj/effect/wingrille_spawn/reinforced,/turf/simulated/floor,/area/space)
"cv" = (/obj/structure/table/steel,/obj/effect/floor_decal/industrial/outline/yellow,/turf/simulated/floor/tiled,/area/space)
"cw" = (/obj/item/weapon/stool,/obj/effect/floor_decal/industrial/warning{dir = 4},/turf/simulated/floor/tiled,/area/space)
"cx" = (/obj/structure/cable/green{d1 = 1; d2 = 2; icon_state = "1-2"},/turf/simulated/floor/reinforced,/area/space)
"cy" = (/obj/machinery/door/airlock/maintenance,/turf/simulated/floor,/area/space)
"cz" = (/obj/effect/floor_decal/industrial/warning{dir = 4},/turf/simulated/floor/tiled,/area/space)
"cA" = (/obj/effect/floor_decal/industrial/hatch/yellow,/obj/effect/floor_decal/industrial/warning/half{icon_state = "warninghalf"; dir = 4},/obj/machinery/door/firedoor,/obj/machinery/door/airlock/mining{name = "Outer Airlock"; req_one_access = newlist()},/turf/simulated/floor/tiled,/area/space)
"cB" = (/obj/effect/floor_decal/industrial/hatch/yellow,/obj/effect/floor_decal/industrial/warning/half{icon_state = "warninghalf"; dir = 4},/obj/machinery/door/firedoor,/turf/simulated/floor/tiled,/area/space)
"cC" = (/obj/structure/cable/green{d1 = 4; d2 = 8; icon_state = "4-8"},/obj/effect/floor_decal/corner/grey_alt{tag = "icon-corner_white (NORTH)"; icon_state = "corner_white"; dir = 1},/turf/simulated/floor/tiled,/area/space)
"cD" = (/obj/machinery/door/firedoor,/obj/structure/cable/green{d1 = 4; d2 = 8; icon_state = "4-8"},/obj/effect/floor_decal/industrial/hatch/yellow,/obj/effect/floor_decal/industrial/warning/half{icon_state = "warninghalf"; dir = 4},/obj/machinery/door/airlock/glass_engineering{name = "Engineering Section"},/turf/simulated/floor/tiled,/area/space)
"cE" = (/obj/structure/cable/green{d1 = 4; d2 = 8; icon_state = "4-8"},/obj/effect/floor_decal/industrial/hatch/yellow,/turf/simulated/floor/tiled,/area/space)
"cF" = (/obj/structure/cable/green{d1 = 4; d2 = 8; icon_state = "4-8"},/obj/structure/cable/green{d1 = 2; d2 = 4; icon_state = "2-4"},/obj/effect/floor_decal/industrial/warning/corner{dir = 4},/turf/simulated/floor/tiled,/area/space)
"cG" = (/obj/structure/cable/green{d1 = 4; d2 = 8; icon_state = "4-8"},/obj/effect/floor_decal/industrial/warning{icon_state = "warning"; dir = 1},/turf/simulated/floor/tiled,/area/space)
"cH" = (/obj/structure/cable/green{d1 = 2; d2 = 8; icon_state = "2-8"},/obj/effect/floor_decal/industrial/warning{icon_state = "warning"; dir = 1},/obj/structure/sign/warning/radioactive{pixel_y = 32},/turf/simulated/floor/tiled,/area/space)
"cI" = (/obj/structure/cable/green{d1 = 1; d2 = 4; icon_state = "1-4"},/obj/effect/floor_decal/industrial/warning{icon_state = "warning"; dir = 1},/turf/simulated/floor/tiled,/area/space)
"cJ" = (/obj/structure/cable/green{d1 = 2; d2 = 4; icon_state = "2-4"},/obj/structure/cable/green{d1 = 2; d2 = 8; icon_state = "2-8"},/obj/effect/floor_decal/industrial/warning{icon_state = "warning"; dir = 1},/turf/simulated/floor/tiled,/area/space)
"cK" = (/obj/machinery/door/firedoor,/obj/machinery/door/airlock/maintenance,/obj/structure/cable/green{d1 = 4; d2 = 8; icon_state = "4-8"},/turf/simulated/floor,/area/space)
"cL" = (/obj/structure/cable/green{d1 = 2; d2 = 8; icon_state = "2-8"},/turf/simulated/floor,/area/space)
"cM" = (/obj/machinery/power/solar_control/autostart,/obj/structure/cable/green{d2 = 2; icon_state = "0-2"},/turf/simulated/floor,/area/space)
"cN" = (/turf/simulated/wall/r_wall,/area/template_noop)
"cO" = (/obj/machinery/door/airlock/vault/bolted{id_tag = "bu_air_inter"; name = "Bunker"},/turf/simulated/floor,/area/space)
"cP" = (/obj/structure/closet/firecloset,/obj/effect/floor_decal/industrial/outline/yellow,/turf/simulated/floor/tiled,/area/space)
"cQ" = (/obj/structure/reagent_dispensers/watertank,/obj/effect/floor_decal/industrial/outline/yellow,/turf/simulated/floor/tiled,/area/space)
"cR" = (/obj/structure/reagent_dispensers/fueltank,/obj/structure/cable/green,/obj/effect/floor_decal/industrial/outline/yellow,/obj/structure/sign/warning/nosmoking_1{pixel_y = -32},/turf/simulated/floor/tiled,/area/space)
"cS" = (/obj/structure/closet/radiation,/obj/effect/floor_decal/industrial/outline/yellow,/turf/simulated/floor/tiled,/area/space)
"cT" = (/obj/structure/closet/crate/uranium,/obj/structure/cable/green{d1 = 1; d2 = 4; icon_state = "1-4"},/obj/effect/floor_decal/industrial/outline/yellow,/turf/simulated/floor/tiled,/area/space)
"cU" = (/obj/machinery/power/smes/buildable/max_cap_in_out,/obj/structure/cable/green{d2 = 8; icon_state = "0-8"},/turf/simulated/floor/tiled,/area/space)
"cV" = (/obj/machinery/power/terminal{dir = 8},/obj/structure/cable/green,/obj/effect/floor_decal/industrial/hatch/yellow,/turf/simulated/floor/tiled,/area/space)
"cW" = (/obj/structure/cable/green{d1 = 1; d2 = 4; icon_state = "1-4"},/turf/simulated/floor,/area/space)
"cX" = (/obj/structure/cable/green{d1 = 4; d2 = 8; icon_state = "4-8"},/obj/structure/cable/green{d1 = 1; d2 = 4; icon_state = "1-4"},/turf/simulated/floor,/area/space)
"cY" = (/obj/structure/cable/green{d1 = 4; d2 = 8; icon_state = "4-8"},/turf/simulated/wall/r_wall,/area/space)
"cZ" = (/obj/structure/cable/green{d1 = 4; d2 = 8; icon_state = "4-8"},/turf/simulated/wall/r_wall,/area/template_noop)
"da" = (/obj/structure/catwalk,/obj/structure/cable/green{d1 = 2; d2 = 8; icon_state = "2-8"},/obj/structure/cable/green{d1 = 1; d2 = 8; icon_state = "1-8"},/obj/structure/cable/green{d1 = 4; d2 = 8; icon_state = "4-8"},/turf/simulated/floor,/area/template_noop)
"db" = (/obj/structure/catwalk,/obj/structure/cable/green{d1 = 4; d2 = 8; icon_state = "4-8"},/turf/simulated/floor,/area/template_noop)
"dc" = (/obj/effect/floor_decal/solarpanel,/obj/machinery/power/tracker,/obj/structure/cable/green{d2 = 8; icon_state = "0-8"},/turf/simulated/floor,/area/template_noop)
"dd" = (/obj/structure/table/reinforced,/turf/simulated/floor/tiled,/area/space)
"de" = (/obj/random/junk,/obj/random/junk,/obj/random/junk,/turf/template_noop,/area/template_noop)
"df" = (/obj/random/junk,/obj/random/junk,/obj/random/junk,/obj/random/junk,/turf/template_noop,/area/template_noop)
"dg" = (/obj/structure/catwalk,/obj/structure/cable/green{d1 = 1; d2 = 4; icon_state = "1-4"},/obj/structure/cable/green{d1 = 1; d2 = 8; icon_state = "1-8"},/obj/structure/cable/green{d1 = 1; d2 = 2; icon_state = "1-2"},/turf/simulated/floor,/area/template_noop)
"dh" = (/obj/machinery/door/airlock/vault/bolted{id_tag = "bu_air_exit"; name = "Bunker"},/turf/simulated/floor,/area/space)
"di" = (/turf/simulated/floor/tiled/airless/asteroid,/area/template_noop)
"dj" = (/obj/structure/net/net_wall,/turf/template_noop,/area/template_noop)
"dk" = (/obj/structure/catwalk,/obj/structure/cable/green{d1 = 1; d2 = 4; icon_state = "1-4"},/obj/structure/cable/green{d1 = 1; d2 = 8; icon_state = "1-8"},/turf/simulated/floor,/area/template_noop)
"dl" = (/obj/machinery/light/spot{dir = 1},/turf/template_noop,/area/space)

(1,1,1) = {"
aaabacacacacacacacacacacacacacacacacacacacacacacadaaaaaeafagahagagahahai
ajakacacacacacacacacacacacacacacacacacacacacacacalalalaaamananaoaoananap
acacacacaqaqaqaqaqaqaqaqaqaqaqaqaqaqaqaqaqaqacarasatalabauananaoaoanaoav
acacacacaqacacacacacacacacacacaqaqacacacacaqacacawaxalaaayaoanananaoanaz
acacaqaqaqacaAaBaCacaDaEaFaGacacacacaHaIacaqacacawaJalaaayanaoananananav
acacaqaeaeacaCaCaCacaKaLaMaMaNaOaMaPaMaQacaqacacawaJalaaauanaoanaRaoaoav
acacaqaeaSacaCaCaCacaTaUaVaWacaMaMacaMaMacaqacacaXaJalaaauaoanaoanananav
acacaqaeaYacacaZacacacbabaacacbbbaacbcbaacaqacacbdbealaaayanaoanaoaoanaz
acacaqbfaYaYaYbgbgbhbgbgbgbibgbgbgbgbgbjbfaqacacbkacacacblanaoaoanananav
acacaqaebmbnaebjbobpbpbpbpbpbpbpbpbpbobqaeaqaqacacacacacayaoananananbrav
acacaqaeaYaeaeaeaeaeaebabaaeaebsbsaeaeaeaeaeaqaqaqaqacacbtbubububububvbw
acacaqaebxbyaebzbjbjbAbBbCbAaebgbjaebDbEbFaeaeaeaeaqacacaaaaaabGabaaaaaa
acacaqaeaYbHaebjbjbjbAbCbCbAbabgbpbabDaCbIaebDbJaeaqacacbKbKbKbLbKbKbKbK
acacaqaeaeaeaeaebMbjbjbAbAbjbabgbpbNaCaCaCbOaCbPaeaqacacbQbRbSbLbQbRbSbK
acacaqbfaYbTaYbUbjbjbjbjbjbjbVbgbpbabDbDbWaebXbYaeaqacacbQbZbSbGbQbZbSbK
acacaqaecacbccaebjbjbjbCcdceaecfbpaeaeaeaeaecgaeaeaqacacbQbZbSbLbQbZbSbK
acacchaeaeaeaeaeaeaeaeaeaeaeaebjbpbfaqaqaqaqaqaqaqaqacacbQbZbSbGbQbZbSbK
acacbjbjbjbjbjciaecjckclckcmaebsbsaeaqaqacacacacacaqacacaacnaabGaacnaabK
acaccocobjbjbjbjaecockcockcoaebgbjaeaeaeacacacacacaqacacbQbZbSbGbQbZbSbK
acaccocobjcpcpcpaeckckckckckcqbgbpaecrcsacacctacacaqacacbQbZbSbGbQbZbSbK
acaccocobjcpcpcpaecococococoaebgbpcucvcwacaccxacaccyacacbQbZbSbGbQbZbSbK
acaccocobjbjbjbjaeaeaeaeaeaeaebgbpcucvczacaccxacacaqacacbQbZbSbLbQbZbSbK
acacbjbjbjbjbjbjcAckckbgbgbjcBbgcCcDcEcFcGcHcIcJcKcLcMaccNcnaabGaacnaabK
acacacaccOcOacaeaeaecPbjbpbpcBbjbpaecQcRcScTcUcVaecWcXcYcZdadbdbdbdadcbK
acacacacaqaqacddbjaeaebfaeaeaeaeaeaeaeaeaeaeaeaeaeaqaqaccNcnaabGaacnaabK
dedfacacaqaqbaddbjbfaqaqaqaqaqaqaqaqaqaqaqaqaqaqcyaqacacbQdgbSbGbQdgbSbK
abajacacaqaqacddbjacacacacacacacacacacacacacacacacacacacbQdgbSbGbQdgbSbK
aaabacacdhdhacacacacacacacacacacacacacacacacacacacacacacbQdgbSbGbQdgbSbK
aaaaacacdidiacacacacacaaaaadaaaaaaaaadaaaaaadjaadjabaabKbQdkbSbGbQdkbSbK
aaaaaaaadididlaaaaaaaaaaabaaaaaaaaaaaaaaabaadjdjdjaaaabKbKbKbKbGbKbKbKbK
"}
