"aa" = (/turf/space,/area/space)
"ab" = (/turf/simulated/floor/asteroid,/area/mine/explored)
"ac" = (/turf/unsimulated/mask,/area/mine/unexplored)
"ad" = (/obj/random/shoes,/turf/space,/area/space)
"ae" = (/obj/effect/overmap/sector/smugglers,/turf/space,/area/space)
"af" = (/turf/simulated/wall/r_wall,/area/smugglers/base)
"ag" = (/obj/machinery/door/airlock/external{frequency = 1503; icon_state = "door_closed"; locked = 0},/turf/simulated/floor/airless/ceiling,/area/smugglers/base)
"ah" = (/turf/simulated/floor/asteroid,/area/space)
"ai" = (/obj/effect/landmark/corpse,/obj/effect/decal/cleanable/blood,/turf/simulated/floor/asteroid,/area/mine/explored)
"aj" = (/obj/item/ammo_casing/a50{pixel_x = 5; pixel_y = 5},/obj/item/ammo_casing/a50,/obj/item/weapon/shovel{pixel_x = 10; pixel_y = -5},/obj/effect/decal/cleanable/blood,/turf/simulated/floor/asteroid,/area/mine/explored)
"ak" = (/obj/effect/decal/cleanable/blood,/turf/simulated/floor/asteroid,/area/mine/explored)
"al" = (/obj/structure/grille,/obj/structure/window/reinforced{dir = 4},/obj/structure/window/reinforced{dir = 8},/obj/structure/window/reinforced{dir = 1},/obj/structure/window/reinforced,/turf/simulated/floor/airless/ceiling,/area/smugglers/base)
"am" = (/obj/machinery/airlock_sensor{frequency = 1503; master_tag = "asteroid_base_dock_airlock"; pixel_x = 25},/obj/machinery/atmospherics/unary/vent_pump/high_volume{dir = 2; frequency = 1503; id_tag = "asteroid_base_dock_pump"},/obj/effect/floor_decal/industrial/warning/full,/obj/item/weapon/beartrap{anchored = 1; deployed = 1; icon_state = "beartrap1"},/turf/simulated/floor/airless/ceiling,/area/smugglers/base)
"an" = (/turf/unsimulated/mask,/area/mine/explored)
"ao" = (/obj/machinery/atmospherics/unary/outlet_injector{injecting = 1; use_power = 1},/turf/simulated/floor/airless,/area/smugglers/base)
"ap" = (/obj/machinery/door/airlock/external{frequency = 1503; icon_state = "door_closed"; locked = 0; name = "Internal Airlock"},/turf/simulated/floor/airless/ceiling,/area/smugglers/base)
"aq" = (/obj/structure/window/reinforced,/obj/structure/window/reinforced{dir = 1},/obj/structure/grille,/obj/structure/window/reinforced{dir = 8},/obj/machinery/door/blast/regular,/obj/structure/cable{icon_state = "0-2"; d2 = 2},/turf/simulated/floor/airless,/area/smugglers/base)
"ar" = (/obj/structure/window/reinforced,/obj/structure/window/reinforced{dir = 1},/obj/structure/grille,/obj/machinery/door/blast/regular,/obj/structure/cable{icon_state = "0-2"; d2 = 2},/turf/simulated/floor/airless,/area/smugglers/base)
"as" = (/obj/structure/window/reinforced,/obj/structure/window/reinforced{dir = 1},/obj/structure/grille,/obj/structure/window/reinforced{dir = 4},/obj/machinery/door/blast/regular,/obj/structure/cable{icon_state = "0-2"; d2 = 2},/turf/simulated/floor/airless,/area/smugglers/base)
"at" = (/obj/item/device/flashlight/glowstick/yellow{pixel_x = 5; pixel_y = 7},/obj/item/device/flashlight/glowstick/yellow,/turf/simulated/floor/asteroid,/area/mine/explored)
"au" = (/obj/effect/decal/cleanable/blood/drip,/obj/machinery/embedded_controller/radio/airlock/airlock_controller{frequency = 1503; id_tag = "asteroid_base_dock_airlock"; name = "Dock Airlock Controller"; pixel_x = -25; tag_airpump = "asteroid_base_dock_pump"; tag_exterior_door = "asteroid_base_dock_outer"; tag_interior_door = "asteroid_base_dock_inner"},/obj/machinery/access_button{command = "cycle_interior"; frequency = 1503; master_tag = "asteroid_base_dock_airlock"; name = "interior access button"; pixel_x = 28; pixel_y = 24; req_one_access = list(13)},/obj/machinery/atmospherics/pipe/simple/visible/black{dir = 5},/turf/simulated/floor/airless/ceiling,/area/smugglers/base)
"av" = (/obj/machinery/portable_atmospherics/canister/air,/obj/machinery/atmospherics/pipe/simple/visible/black{dir = 4},/turf/simulated/floor/airless/ceiling,/area/smugglers/base)
"aw" = (/obj/machinery/floodlight,/obj/machinery/atmospherics/pipe/simple/visible/black{dir = 4},/turf/simulated/floor/airless/ceiling,/area/smugglers/base)
"ax" = (/obj/item/stack/cable_coil{pixel_x = 5; pixel_y = 5; pixel_z = 0},/obj/item/stack/cable_coil,/obj/machinery/power/apc{dir = 1; name = "Asteroid base main APC"; pixel_x = 0; pixel_y = 24},/obj/structure/cable{icon_state = "0-2"; d2 = 2},/obj/machinery/atmospherics/pipe/simple/visible/black{dir = 4},/turf/simulated/floor/airless/ceiling,/area/smugglers/base)
"ay" = (/obj/machinery/power/port_gen/pacman,/obj/structure/cable{icon_state = "0-2"; d2 = 2},/obj/machinery/atmospherics/pipe/simple/visible/black{dir = 4},/turf/simulated/floor/airless/ceiling,/area/smugglers/base)
"az" = (/obj/item/stack/material/phoron{pixel_y = 7; pixel_z = -8},/obj/item/stack/material/phoron{pixel_x = -5; pixel_y = 5},/obj/item/stack/material/phoron,/obj/machinery/atmospherics/pipe/simple/visible/black{dir = 4},/turf/simulated/floor/airless/ceiling,/area/smugglers/base)
"aA" = (/obj/machinery/atmospherics/portables_connector{dir = 1},/obj/machinery/portable_atmospherics/powered/scrubber,/obj/machinery/atmospherics/pipe/simple/visible/black{dir = 4},/obj/structure/cable{d1 = 1; d2 = 2; icon_state = "1-2"; pixel_y = 0},/turf/simulated/floor/airless/ceiling,/area/smugglers/base)
"aB" = (/obj/machinery/atmospherics/pipe/simple/visible/black{dir = 4},/obj/structure/cable{d1 = 1; d2 = 2; icon_state = "1-2"; pixel_y = 0},/turf/simulated/floor/airless/ceiling,/area/smugglers/base)
"aC" = (/obj/machinery/atmospherics/pipe/manifold/visible/black{icon_state = "map"; dir = 1},/obj/structure/cable{d1 = 1; d2 = 2; icon_state = "1-2"; pixel_y = 0},/turf/simulated/floor/airless/ceiling,/area/smugglers/base)
"aD" = (/obj/machinery/door/airlock/maintenance,/obj/machinery/atmospherics/pipe/simple/visible/black{dir = 4},/turf/simulated/floor/airless/ceiling,/area/smugglers/base)
"aE" = (/obj/effect/decal/cleanable/dirt,/obj/machinery/atmospherics/pipe/simple/visible/black{dir = 4},/turf/simulated/floor/airless/ceiling,/area/smugglers/base)
"aF" = (/obj/machinery/atmospherics/pipe/simple/visible/black{dir = 4},/turf/simulated/floor/airless/ceiling,/area/smugglers/base)
"aG" = (/obj/machinery/embedded_controller/radio/airlock/airlock_controller{frequency = 1501; id_tag = "asteroid_base_east_airlock"; pixel_y = 25; tag_airpump = "asteroid_base_east_pump"; tag_exterior_door = "asteroid_base_east_outer"; tag_exterior_sensor = null; tag_interior_door = "asteroid_base_east_inner"; tag_interior_sensor = null},/obj/machinery/access_button{command = "cycle_interior"; frequency = 1501; master_tag = "asteroid_base_east_airlock"; name = "interior access button"; pixel_x = -28; pixel_y = 24; req_one_access = list(13)},/obj/machinery/atmospherics/pipe/simple/visible/black{dir = 4},/turf/simulated/floor/airless/ceiling,/area/smugglers/base)
"aH" = (/obj/machinery/door/airlock/external{frequency = 1501; icon_state = "door_locked"; id_tag = "asteroid_base_east_inner"; locked = 1; name = "Internal Airlock"},/obj/machinery/atmospherics/pipe/simple/visible/black{dir = 4},/turf/simulated/floor/airless/ceiling,/area/smugglers/base)
"aI" = (/obj/item/weapon/beartrap{anchored = 1; deployed = 1; icon_state = "beartrap1"},/obj/machinery/airlock_sensor{frequency = 1501; master_tag = "asteroid_base_east_airlock"; pixel_y = -25},/obj/machinery/atmospherics/unary/vent_pump/high_volume{dir = 8; frequency = 1501; id_tag = "asteroid_base_east_pump"},/obj/effect/floor_decal/industrial/warning/full,/turf/simulated/floor/airless/ceiling,/area/smugglers/base)
"aJ" = (/obj/machinery/door/airlock/external{frequency = 1501; icon_state = "door_locked"; id_tag = "asteroid_base_east_outer"; locked = 1},/turf/simulated/floor/airless/ceiling,/area/smugglers/base)
"aK" = (/obj/machinery/access_button/airlock_exterior{frequency = 1501; master_tag = "asteroid_base_east_airlock"; name = "exterior access button"; pixel_x = -25; pixel_y = 25},/turf/simulated/floor/asteroid,/area/mine/explored)
"aL" = (/obj/random/trash,/turf/simulated/floor/asteroid,/area/mine/explored)
"aM" = (/obj/machinery/light/small{dir = 8},/obj/structure/cable{d1 = 2; d2 = 4; icon_state = "2-4"},/turf/simulated/floor/airless/ceiling,/area/smugglers/base)
"aN" = (/obj/structure/cable{d1 = 4; d2 = 8; icon_state = "4-8"},/turf/simulated/floor/airless/ceiling,/area/smugglers/base)
"aO" = (/obj/effect/decal/cleanable/blood/drip,/obj/structure/cable{d1 = 4; d2 = 8; icon_state = "4-8"},/obj/item/weapon/wirecutters,/turf/simulated/floor/airless/ceiling,/area/smugglers/base)
"aP" = (/obj/structure/cable,/obj/structure/cable{d1 = 32; d2 = 4; icon_state = "32-4"},/obj/structure/cable{icon_state = "0-2"; dir = 4; pixel_y = 0; d1 = 16; d2 = 0},/obj/structure/cable{d2 = 8; icon_state = "0-8"},/turf/simulated/floor/airless/ceiling,/area/smugglers/base)
"aQ" = (/obj/structure/cable{d1 = 4; d2 = 8; icon_state = "4-8"},/obj/structure/cable{d1 = 1; d2 = 8; icon_state = "1-8"},/turf/simulated/floor/airless/ceiling,/area/smugglers/base)
"aR" = (/obj/effect/decal/cleanable/blood/drip,/obj/structure/cable{d1 = 4; d2 = 8; icon_state = "4-8"},/obj/structure/cable{d1 = 1; d2 = 8; icon_state = "1-8"},/turf/simulated/floor/airless/ceiling,/area/smugglers/base)
"aS" = (/obj/machinery/light/small{dir = 4; pixel_y = 8},/obj/structure/cable{d1 = 2; d2 = 8; icon_state = "2-8"},/obj/machinery/atmospherics/pipe/simple/visible/black,/obj/structure/cable{d1 = 1; d2 = 8; icon_state = "1-8"},/turf/simulated/floor/airless/ceiling,/area/smugglers/base)
"aT" = (/turf/simulated/wall,/area/smugglers/base)
"aU" = (/obj/machinery/light/small/red{dir = 8},/turf/simulated/floor/airless/ceiling,/area/smugglers/base)
"aV" = (/obj/effect/decal/cleanable/dirt,/turf/simulated/floor/airless/ceiling,/area/smugglers/base)
"aW" = (/obj/structure/table/rack{dir = 8; layer = 2.9},/obj/item/clothing/mask/breath,/turf/simulated/floor/airless/ceiling,/area/smugglers/base)
"aX" = (/obj/structure/cable{d1 = 1; d2 = 2; icon_state = "1-2"},/turf/simulated/floor/airless/ceiling,/area/smugglers/base)
"aY" = (/obj/random/trash,/turf/simulated/floor/airless/ceiling,/area/smugglers/base)
"aZ" = (/obj/structure/closet/crate/plastic_smug_ammo,/obj/effect/floor_decal/industrial/warning{dir = 9},/turf/simulated/floor/airless/ceiling,/area/smugglers/base)
"ba" = (/obj/effect/floor_decal/industrial/warning{dir = 1},/obj/item/weapon/paper/smug_1,/turf/simulated/floor/airless/ceiling,/area/smugglers/base)
"bb" = (/obj/random/ore_smug,/obj/effect/floor_decal/industrial/warning{dir = 5},/turf/simulated/floor/airless/ceiling,/area/smugglers/base)
"bc" = (/turf/simulated/floor/airless/ceiling,/area/smugglers/base)
"bd" = (/obj/structure/cable{d1 = 1; d2 = 2; icon_state = "1-2"},/obj/machinery/atmospherics/pipe/simple/visible/black,/turf/simulated/floor/airless/ceiling,/area/smugglers/base)
"be" = (/obj/structure/table/rack{dir = 8; layer = 2.9},/obj/item/weapon/tank/air{pixel_x = 5},/obj/item/weapon/tank/air,/turf/simulated/floor/airless/ceiling,/area/smugglers/base)
"bf" = (/obj/item/weapon/pickaxe/hand{pixel_x = -15},/turf/simulated/floor/asteroid,/area/mine/explored)
"bg" = (/obj/effect/floor_decal/industrial/warning{dir = 8},/turf/simulated/floor/airless/ceiling,/area/smugglers/base)
"bh" = (/obj/structure/closet/crate/plastic_smug_weapons,/turf/simulated/floor/airless/ceiling,/area/smugglers/base)
"bi" = (/obj/structure/closet/crate/plastic,/obj/random/action_figure,/obj/random/loot,/obj/random/loot,/obj/random/smokes,/obj/random/smokes,/obj/effect/floor_decal/industrial/warning{icon_state = "warning"; dir = 4},/turf/simulated/floor/airless/ceiling,/area/smugglers/base)
"bj" = (/obj/machinery/floodlight,/turf/simulated/floor/airless/ceiling,/area/smugglers/base)
"bk" = (/obj/machinery/portable_atmospherics/canister/oxygen,/obj/machinery/light/small/red,/turf/simulated/floor/airless/ceiling,/area/smugglers/base)
"bl" = (/obj/structure/table/rack{dir = 8; layer = 2.9},/obj/random/voidsuit,/obj/random/voidhelmet,/turf/simulated/floor/airless/ceiling,/area/smugglers/base)
"bm" = (/obj/structure/boulder,/turf/simulated/floor/asteroid,/area/mine/explored)
"bn" = (/obj/item/weapon/ore/silver,/obj/item/weapon/ore/silver{pixel_x = 10; pixel_y = -5},/turf/simulated/floor/asteroid,/area/mine/explored)
"bo" = (/obj/structure/cable{d1 = 1; d2 = 2; icon_state = "1-2"},/obj/machinery/light/small{dir = 8},/turf/simulated/floor/airless/ceiling,/area/smugglers/base)
"bp" = (/obj/item/weapon/paper/smug_2,/turf/simulated/floor/airless/ceiling,/area/smugglers/base)
"bq" = (/obj/structure/ore_box,/obj/random/ore_smug,/obj/random/ore_smug,/obj/random/ore_smug,/obj/random/ore_smug,/obj/random/ore_smug,/obj/random/ore_smug,/obj/random/ore_smug,/obj/random/ore_smug,/obj/random/ore_smug,/obj/random/ore_smug,/obj/random/ore_smug,/obj/random/ore_smug,/obj/random/ore_smug,/obj/random/ore_smug,/obj/random/ore_smug,/obj/effect/floor_decal/industrial/warning{dir = 8},/turf/simulated/floor/airless/ceiling,/area/smugglers/base)
"br" = (/obj/structure/ore_box,/obj/random/ore_smug,/obj/random/ore_smug,/obj/random/ore_smug,/obj/random/ore_smug,/obj/random/ore_smug,/obj/random/ore_smug,/obj/random/ore_smug,/obj/random/ore_smug,/obj/random/ore_smug,/obj/random/ore_smug,/obj/random/ore_smug,/turf/simulated/floor/airless/ceiling,/area/smugglers/base)
"bs" = (/obj/effect/floor_decal/industrial/warning{icon_state = "warning"; dir = 4},/turf/simulated/floor/airless/ceiling,/area/smugglers/base)
"bt" = (/obj/structure/cable{d1 = 1; d2 = 2; icon_state = "1-2"},/obj/machinery/light/small{dir = 4; pixel_y = 8},/obj/machinery/atmospherics/pipe/simple/visible/black,/turf/simulated/floor/airless/ceiling,/area/smugglers/base)
"bu" = (/turf/simulated/wall,/area/smugglers/office)
"bv" = (/turf/simulated/wall/r_wall,/area/smugglers/office)
"bw" = (/obj/item/weapon/ore/slag,/obj/item/weapon/ore/slag{pixel_x = 5; pixel_y = -2},/obj/item/weapon/ore/slag,/turf/simulated/floor/airless/ceiling,/area/smugglers/base)
"bx" = (/obj/structure/ore_box,/obj/random/ore_smug,/obj/random/ore_smug,/obj/random/ore_smug,/obj/random/ore_smug,/obj/random/ore_smug,/obj/random/ore_smug,/obj/random/ore_smug,/obj/effect/floor_decal/industrial/warning{dir = 8},/turf/simulated/floor/airless/ceiling,/area/smugglers/base)
"by" = (/obj/random/ore_smug,/turf/simulated/floor/airless/ceiling,/area/smugglers/base)
"bz" = (/obj/structure/cable{d1 = 1; d2 = 4; icon_state = "1-4"},/obj/machinery/atmospherics/binary/pump{dir = 1},/turf/simulated/floor/airless/ceiling,/area/smugglers/base)
"bA" = (/obj/machinery/door/airlock/maintenance,/obj/structure/cable{d1 = 4; d2 = 8; icon_state = "4-8"},/turf/simulated/floor/airless/ceiling,/area/smugglers/office)
"bB" = (/obj/structure/cable{d1 = 4; d2 = 8; icon_state = "4-8"},/obj/effect/decal/cleanable/dirt,/turf/simulated/floor/tiled,/area/smugglers/office)
"bC" = (/obj/structure/table/woodentable,/obj/item/weapon/paper,/obj/item/weapon/pen,/obj/item/device/flashlight/lamp,/obj/structure/cable{d2 = 8; icon_state = "0-8"},/obj/machinery/power/apc{dir = 1; name = "Asteroid base office APC"; pixel_x = 0; pixel_y = 24},/turf/simulated/floor/tiled,/area/smugglers/office)
"bD" = (/obj/structure/safe/floor,/obj/random/contraband,/obj/random/contraband,/obj/random/loot,/obj/random/projectile,/obj/random/cash,/obj/random/cash,/obj/random/cash,/turf/simulated/floor/tiled,/area/smugglers/office)
"bE" = (/obj/effect/floor_decal/industrial/warning{icon_state = "warning"; dir = 10},/turf/simulated/floor/airless/ceiling,/area/smugglers/base)
"bF" = (/obj/effect/floor_decal/industrial/warning,/turf/simulated/floor/airless/ceiling,/area/smugglers/base)
"bG" = (/obj/effect/floor_decal/industrial/warning{dir = 6},/turf/simulated/floor/airless/ceiling,/area/smugglers/base)
"bH" = (/obj/machinery/atmospherics/portables_connector{dir = 1},/obj/machinery/portable_atmospherics/canister/air,/turf/simulated/floor/airless/ceiling,/area/smugglers/base)
"bI" = (/obj/effect/decal/cleanable/dirt,/turf/simulated/floor/tiled,/area/smugglers/office)
"bJ" = (/obj/structure/table/woodentable,/obj/random/coin{pixel_x = -5; pixel_y = -3},/obj/random/coin,/obj/item/weapon/storage/bible/booze{pixel_x = 10},/obj/item/weapon/paper/smug_4{pixel_x = -5; pixel_y = 4},/obj/item/weapon/paper/smug_5,/turf/simulated/floor/tiled,/area/smugglers/office)
"bK" = (/obj/structure/bed/chair/comfy/red{dir = 8},/obj/machinery/light{icon_state = "tube1"; dir = 4},/turf/simulated/floor/tiled,/area/smugglers/office)
"bL" = (/obj/effect/decal/cleanable/blood,/turf/simulated/floor/airless/ceiling,/area/smugglers/base)
"bM" = (/obj/machinery/atmospherics/portables_connector,/obj/machinery/portable_atmospherics/powered/scrubber,/turf/simulated/floor/airless/ceiling,/area/smugglers/base)
"bN" = (/obj/machinery/portable_atmospherics/canister/air,/obj/item/weapon/wrench,/obj/machinery/light/small{dir = 4; pixel_y = 8},/turf/simulated/floor/airless/ceiling,/area/smugglers/base)
"bO" = (/mob/living/simple_animal/hostile/retaliate/malf_drone,/turf/simulated/floor/tiled,/area/smugglers/office)
"bP" = (/turf/simulated/floor/tiled,/area/smugglers/office)
"bQ" = (/obj/structure/table/standard,/obj/random/tech_supply,/turf/simulated/floor/airless/ceiling,/area/smugglers/base)
"bR" = (/obj/structure/table/standard,/obj/random/toolbox,/turf/simulated/floor/airless/ceiling,/area/smugglers/base)
"bS" = (/obj/structure/table/standard,/obj/random/firstaid,/turf/simulated/floor/airless/ceiling,/area/smugglers/base)
"bT" = (/obj/structure/closet/crate/trashcart,/turf/simulated/floor/airless/ceiling,/area/smugglers/base)
"bU" = (/obj/machinery/atmospherics/portables_connector{dir = 1},/obj/machinery/portable_atmospherics/canister,/turf/simulated/floor/airless/ceiling,/area/smugglers/base)
"bV" = (/obj/machinery/portable_atmospherics/canister/air,/turf/simulated/floor/airless/ceiling,/area/smugglers/base)
"bW" = (/obj/machinery/constructable_frame/machine_frame,/obj/random/trash,/turf/simulated/floor/tiled,/area/smugglers/office)
"bX" = (/obj/structure/table/rack,/obj/item/clothing/head/cowboy_hat,/obj/item/clothing/suit/armor/hos/jensen,/turf/simulated/floor/tiled,/area/smugglers/office)
"bY" = (/obj/structure/filingcabinet/chestdrawer,/turf/simulated/floor/tiled,/area/smugglers/office)
"bZ" = (/turf/simulated/wall/r_wall,/area/smugglers/dorms)
"ca" = (/obj/machinery/door/airlock/maintenance{name = "Restroom"},/obj/structure/cable{d1 = 1; d2 = 2; icon_state = "1-2"},/turf/simulated/floor/airless/ceiling,/area/smugglers/dorms)
"cb" = (/turf/simulated/wall,/area/smugglers/dorms)
"cc" = (/obj/effect/decal/cleanable/dirt,/obj/effect/decal/cleanable/dirt,/obj/structure/cable{d1 = 1; d2 = 2; icon_state = "1-2"},/turf/simulated/floor/tiled,/area/smugglers/dorms)
"cd" = (/obj/structure/noticeboard{pixel_y = 30},/obj/effect/decal/cleanable/dirt,/obj/structure/table/standard,/obj/machinery/microwave{pixel_y = 10},/turf/simulated/floor/tiled,/area/smugglers/dorms)
"ce" = (/obj/effect/decal/cleanable/dirt,/obj/structure/closet/crate,/obj/random/snack,/obj/random/snack,/obj/random/snack,/obj/random/snack,/obj/random/snack,/turf/simulated/floor/tiled,/area/smugglers/dorms)
"cf" = (/obj/effect/decal/cleanable/dirt,/obj/structure/closet/crate,/obj/random/drinkbottle,/obj/random/drinkbottle,/turf/simulated/floor/tiled,/area/smugglers/dorms)
"cg" = (/obj/effect/decal/cleanable/dirt,/obj/machinery/computer/arcade,/turf/simulated/floor/tiled,/area/smugglers/dorms)
"ch" = (/obj/structure/closet/crate/freezer/rations,/obj/effect/decal/cleanable/cobweb2,/obj/effect/decal/cleanable/dirt,/turf/simulated/floor/tiled,/area/smugglers/dorms)
"ci" = (/obj/effect/decal/cleanable/cobweb,/turf/simulated/floor/airless/ceiling,/area/smugglers/dorms)
"cj" = (/obj/machinery/light/small{dir = 4},/obj/structure/sink{pixel_y = 15},/obj/structure/mirror{pixel_y = 30},/obj/random/soap,/turf/simulated/floor/airless/ceiling,/area/smugglers/dorms)
"ck" = (/obj/effect/decal/cleanable/dirt,/obj/effect/decal/cleanable/dirt,/obj/structure/cable,/obj/machinery/power/apc{dir = 8; name = "west bump"; pixel_x = -24},/turf/simulated/floor/tiled,/area/smugglers/dorms)
"cl" = (/obj/effect/decal/cleanable/dirt,/turf/simulated/floor/tiled,/area/smugglers/dorms)
"cm" = (/obj/effect/decal/cleanable/dirt,/obj/effect/decal/cleanable/dirt,/turf/simulated/floor/tiled,/area/smugglers/dorms)
"cn" = (/obj/machinery/door/airlock/maintenance{name = "Toilet"},/turf/simulated/floor,/area/smugglers/dorms)
"co" = (/obj/effect/decal/cleanable/vomit,/obj/random/medical/lite,/turf/simulated/floor/airless/ceiling,/area/smugglers/dorms)
"cp" = (/obj/structure/toilet{dir = 8},/turf/simulated/floor/airless/ceiling,/area/smugglers/dorms)
"cq" = (/obj/structure/bed/chair{dir = 4},/obj/machinery/light,/obj/random/trash,/turf/simulated/floor/tiled,/area/smugglers/dorms)
"cr" = (/obj/structure/table/standard,/obj/effect/decal/cleanable/dirt,/obj/item/weapon/paper/smug_3,/obj/item/weapon/flame/lighter/random,/obj/random/coin,/turf/simulated/floor/tiled,/area/smugglers/dorms)
"cs" = (/obj/structure/table/standard,/obj/effect/decal/cleanable/dirt,/obj/item/weapon/spacecash/bundle/c10,/obj/random/smokes,/obj/random/snack,/turf/simulated/floor/tiled,/area/smugglers/dorms)
"ct" = (/obj/structure/bed/chair{dir = 8},/obj/machinery/light,/turf/simulated/floor/tiled,/area/smugglers/dorms)
"cu" = (/obj/structure/closet,/obj/effect/decal/cleanable/dirt,/obj/random/medical,/obj/random/medical,/obj/random/tech_supply,/obj/random/action_figure,/turf/simulated/floor/tiled,/area/smugglers/dorms)
"cv" = (/obj/machinery/door/airlock/maintenance,/turf/simulated/floor/tiled,/area/smugglers/dorms)
"cw" = (/obj/structure/bed,/obj/effect/decal/cleanable/dirt,/turf/simulated/floor/tiled,/area/smugglers/dorms)
"cx" = (/obj/structure/closet/smuggler,/obj/random/suit,/obj/effect/decal/cleanable/dirt,/turf/simulated/floor/tiled,/area/smugglers/dorms)
"cy" = (/obj/structure/bed,/obj/effect/decal/cleanable/dirt,/mob/living/simple_animal/hostile/retaliate/malf_drone,/turf/simulated/floor/tiled,/area/smugglers/dorms)
"cz" = (/obj/effect/decal/cleanable/dirt,/obj/random/trash,/turf/simulated/floor/tiled,/area/smugglers/dorms)
"cA" = (/obj/machinery/light/small{dir = 2},/obj/effect/decal/cleanable/dirt,/turf/simulated/floor/tiled,/area/smugglers/dorms)
"cB" = (/obj/effect/shuttle_landmark/nav_asteroid_base/nav1,/turf/simulated/floor/asteroid,/area/mine/explored)
"cC" = (/obj/effect/shuttle_landmark/nav_asteroid_base/nav2,/turf/space,/area/space)
"cD" = (/obj/effect/landmark/random_gen/asteroid{generation_height = 50; generation_width = 50},/turf/space,/area/space)

(1,1,1) = {"
aaaaaaaaaaaaaaaaaaaaaaaaaaaaaaaaaaaaabaaababacaaaaaaaaaaacaaababacaaaaaaacacaaacaaaaaaaaaaaaaaaaaaaa
aaaaaaabacacaaaaaaaaaaaaaaaaaaaaaaaaabababababacacaaaaaaacacacabacaaadaaacacaaacacaaaaaaaaaaaaaaaaaa
aaaaaaababacaaaaaaaeaaaaaaaaaaaaaaaaaaabacacababababaaaaaaacacacabaaaaaaaaacacacacaaaaaaaaaaaaaaaaaa
aaaaaaacababaaaaafagafaaaaahaaaaaaaaaaabacacababaaabaaaaaaacacaiajakakaaaaacacacacacacacaaaaaaaaaaaa
aaaaaaaaacabababalamafaaahanaaaoaaaaaaacacacabababacacacacacacabacacabababababacacababacababaaaaaaaa
aaaaaaaaacababacafapafafafafafaqarasafafafafafafafatacacacacabacacacabababababacababacacacabaaaaaaaa
aaaaaaaaababababafauavawaxayazaAaBaCaDaEaFaGaHaIaJaKababacacabacababaLabababababababacacacabaaaaaaaa
aaaaaaaaababacacafaMaNaOaPaPaNaQaRaSaTaUaVaWafafafacabababababababababacabababababacacacacaaaaaaaaaa
aaaaaaaaabacacacafaXaYaZbabbbcbcaYbdaTaYbcbeafacacacacacacacbfababacacababababacacacacacacaaaaaaaaaa
aaaaaaaaacacacacafaXbcbgbhbibcbcbcbdaTbjbkblafacacacacacacacbmbnabacacabacacacabacacacacacabaaaaaaaa
aaaaaaabacacacacafbobpbqbrbsbcaYbcbtbububububvacacacacacacacacacacacacababababababababaaaaaaaaaaaaaa
aaaaaaababacacacafaXbwbxbybsbcbcbcbzbAbBbCbDbvacacacacacacacacacacacacacacacaLababacabaaaaaaaaaaaaaa
aaaaaaacabacacacafaXaYbEbFbGbcbcbcbHbubIbJbKbvabacacacacacacacacacacacacacacacabacababaaaaaaaaaaaaaa
aaaaaaacababacacafbobcbcbcbcbLbMbcbNbubIbObPbvacacacacacacacacacacababacacacacabacabacaaaaaaaaaaaaaa
aaaaaaaaaaacacabafaXaYbQbRbSbTbUbcbVbubWbXbYbvacabababababacacacacabacacacacacacabababaaaaabaaaaaaaa
aaaaaaaaaaacacabbZcacbcbcbcbcbcbcbcbbZbvbvbvbvacabababababacacacacababacacacacabacacabaaaaabaaaaaaaa
aaaaaaaaaaaaacacbZcccdcecfcgchcbcicjbZacacacacacacacabacacacacacacabababacacacaLabababacacacaaaaaaaa
aaaaaaaaabacacacbZckclclclclcmcncocpbZababababababacanacacacacacacacabababacacabacacacacacaaaaaaaaaa
aaaaaaaaababacacbZclcqcrcsctcucbbZbZbZacacacabababacababacacacacabacacacacacacabacacacacacaaaaaaaaaa
aaaaaaaaaaabacacbZcvcbcbcbcbcbcbbZabacacacacabababababaLabacacababacacacacacababacacababababacaaaaaa
aaaaaaaaaaabacacbZclcwcxcycxcwcxbZabacacacacacacababacacababababacacacababababacacacabababacacaaaaaa
aaaaaaacaaababacbZczcAclclclcAclbZacacacabababababacacacababacababacacaLacacacacacacabababacacaaaaaa
aaaaaaababababacbZbZbZbZbZbZbZbZbZacabababababacacacacacabacacacababababacacacaaaaaaaaaaaaaaacaaaaaa
aaaaaaaaaaaaabacacababacacacacacabababaLacacacabacacacacacacacacacacacacacaaaaaaaaaaaaaaaaaaaaaaaaaa
aaaaaaaaaaaaacacacabacacacacacacacacacaLabacabacacacaaaaacacacacacacacaaaaaaaaaaaaaaaaaaaaaaaaaaaaaa
aaaaaaaaaaaaaaabacabacacacacababababaLabababababacacacaaaaacacacacabacaaaaaaaaaaaaaaaaaaaaaaaaaaaaaa
aaaaaaaaaaaaababacabacacababababababababababababababacaaaaacacacacabaaaaaaaaaaaaaaaaaaaaaaaaaaaaaaaa
aaaaaaaaaaaaaaabababacabababababababababababababababacacacacacacacacaaaaaaaaaaaaaaaaaaaaaaaaaaaaaaaa
aaaaaaaaaaaaaaabababacababababababababababababababababacacababacaaaaaaaaaaaaaaaaaaaaaaaaaaaaaaaaaaaa
aaaaaaaaaaaaababacacacabababababababababababababababacacababababaaaaaaaaaaaaaaaaaaaaaaaaaaaaaaaaaaaa
aaaaaaaaaaaaababacacababababababababababababababababacacacacabaaaaaaaaaaaaaaaaaaaaaaaaaaaaaaaaaaaaaa
aaaaaaaaaaaaababaaaaabababababababababababababababababababababaaaaaaaaaaaaaaaaaaaaaaaaaaaaaaaaaaaaaa
aaaaaaaaaaaaaaaaaaaaabababababababababababababababababacacacacaaaaaaaaaaaaaaaaaaaaaaaaaaaaaaaaaaaaaa
aaaaaaaaaaaaaaaaaaaaababababababababcBabababababababababacacacaaaaaaaaaaaaaaaaaaaaaaaaaaaaaaaaaaaaaa
aaaaaaaaaaaaaaaaaaaaabababababababababababababababababacacaaaaaaaaaaaaaaaaaaaaaaaacCaaaaaaaaaaaaaaaa
aaaaaaaaaaaaaaaaaaaaababababababababababababababababababacaaaaaaaaaaaaaaaaaaaaaaaaaaaaaaaaaaaaaaaaaa
aaaaaaaaaaaaaaaaacacabababababababababababababababababababaaaaaaaaaaaaaaaaaaaaaaaaaaaaaaaaaaaaaaaaaa
aaaaaaaaaaaaaaaaaaacacabababababababababababababababacacabacacaaaaaaaaaaaaaaaaaaaaaaaaaaaaaaaaaaaaaa
aaaaaaaaaaaaaaacacacacacababababababababababababababacacabababaaaaaaaaaaaaaaaaaaaaaaaaaaaaaaaaaaaaaa
aaaaaaaaaaaaaaacacacacacacabababababababababababababababacacacabaaaaaaaaaaaaaaaaaaaaaaaaaaaaaaaaaaaa
aaaaaaaaaaaaaaacacabacacacababababababababababababababababababababaaaaaaaaaaaaaaaaaaaaaaaaaaaaaaaaaa
aaaaaaaaaaaaaaacacacacacacacacacabababababababababacabababacacacacaaaaaaaaaaaaaaaaaaaaaaaaaaaaaaaaaa
aaaaaaaaaaaaaaacacacacaaaaaaaaacacacacababacacabababacacacacaaaaaaaaaaaaaaaaaaaaaaaaaaaaaaaaaaaaaaaa
aaaaaaaaaaacacacacacacaaaaaaaaaaaaacabababababacacacacacacacaaaaaaaaaaaaaaaaaaaaaaaaaaaaaaaaaaaaaaaa
aaaaaaaaaaacacacacabaaaaaaaaaaaaaaaaaaaaaaaaacacacaaaaaaaaaaaaaaaaaaaaaaaaaaaaaaaaaaaaaaaaaaaaaaaaaa
aaaaaaaaaaaaaaaaaaabaaaaaaaaaaaaaaaaaaaaaaaaacacacaaaaaaaaaaaaaaaaaaaaaaaaaaaaaaaaaaaaaaaaaaaaaaaaaa
aaaaaaaaaaaaaaaaaaaaaaaaaaaaaaaaaaaaaaaaaaaaaaaaaaaaaaaaaaaaaaaaaaaaaaaaaaaaaaaaaaaaaaaaaaaaaaaaaaaa
cDaaaaaaaaaaaaaaaaaaaaaaaaaaaaaaaaaaaaaaaaaaaaaaaaaaaaaaaaaaaaaaaaaaaaaaaaaaaaaaaaaaaaaaaaaaaaaaaaaa
aaaaaaaaaaaaaaaaaaaaaaaaaaaaaaaaaaaaaaaaaaaaaaaaaaaaaaaaaaaaaaaaaaaaaaaaaaaaaaaaaaaaaaaaaaaaaaaaaaaa
aaaaaaaaaaaaaaaaaaaaaaaaaaaaaaaaaaaaaaaaaaaaaaaaaaaaaaaaaaaaaaaaaaaaaaaaaaaaaaaaaaaaaaaaaaaaaaaaaaaa
aaaaaaaaaaaaaaaaaaaaaaaaaaaaaaaaaaaaaaaaaaaaaaaaaaaaaaaaaaaaaaaaaaaaaaaaaaaaaaaaaaaaaaaaaaaaaaaaaaaa
aaaaaaaaaaaaaaaaaaaaaaaaaaaaaaaaaaaaaaaaaaaaaaaaaaaaaaaaaaaaaaaaaaaaaaaaaaaaaaaaaaaaaaaaaaaaaaaaaaaa
aaaaaaaaaaaaaaaaaaaaaaaaaaaaaaaaaaaaaaaaaaaaaaaaaaaaaaaaaaaaaaaaaaaaaaaaaaaaaaaaaaaaaaaaaaaaaaaaaaaa
aaaaaaaaaaaaaaaaaaaaaaaaaaaaaaaaaaaaaaaaaaaaaaaaaaaaaaaaaaaaaaaaaaaaaaaaaaaaaaaaaaaaaaaaaaaaaaaaaaaa
aaaaaaaaaaaaaaaaaaaaaaaaaaaaaaaaaaaaaaaaaaaaaaaaaaaaaaaaaaaaaaaaaaaaaaaaaaaaaaaaaaaaaaaaaaaaaaaaaaaa
aaaaaaaaaaaaaaaaaaaaaaaaaaaaaaaaaaaaaaaaaaaaaaaaaaaaaaaaaaaaaaaaaaaaaaaaaaaaaaaaaaaaaaaaaaaaaaaaaaaa
aaaaaaaaaaaaaaaaaaaaaaaaaaaaaaaaaaaaaaaaaaaaaaaaaaaaaaaaaaaaaaaaaaaaaaaaaaaaaaaaaaaaaaaaaaaaaaaaaaaa
aaaaaaaaaaaaaaaaaaaaaaaaaaaaaaaaaaaaaaaaaaaaaaaaaaaaaaaaaaaaaaaaaaaaaaaaaaaaaaaaaaaaaaaaaaaaaaaaaaaa
aaaaaaaaaaaaaaaaaaaaaaaaaaaaaaaaaaaaaaaaaaaaaaaaaaaaaaaaaaaaaaaaaaaaaaaaaaaaaaaaaaaaaaaaaaaaaaaaaaaa
aaaaaaaaaaaaaaaaaaaaaaaaaaaaaaaaaaaaaaaaaaaaaaaaaaaaaaaaaaaaaaaaaaaaaaaaaaaaaaaaaaaaaaaaaaaaaaaaaaaa
aaaaaaaaaaaaaaaaaaaaaaaaaaaaaaaaaaaaaaaaaaaaaaaaaaaaaaaaaaaaaaaaaaaaaaaaaaaaaaaaaaaaaaaaaaaaaaaaaaaa
aaaaaaaaaaaaaaaaaaaaaaaaaaaaaaaaaaaaaaaaaaaaaaaaaaaaaaaaaaaaaaaaaaaaaaaaaaaaaaaaaaaaaaaaaaaaaaaaaaaa
aaaaaaaaaaaaaaaaaaaaaaaaaaaaaaaaaaaaaaaaaaaaaaaaaaaaaaaaaaaaaaaaaaaaaaaaaaaaaaaaaaaaaaaaaaaaaaaaaaaa
aaaaaaaaaaaaaaaaaaaaaaaaaaaaaaaaaaaaaaaaaaaaaaaaaaaaaaaaaaaaaaaaaaaaaaaaaaaaaaaaaaaaaaaaaaaaaaaaaaaa
aaaaaaaaaaaaaaaaaaaaaaaaaaaaaaaaaaaaaaaaaaaaaaaaaaaaaaaaaaaaaaaaaaaaaaaaaaaaaaaaaaaaaaaaaaaaaaaaaaaa
"}
